
|||||·|·||||||||
················
|·||·|||||||·||·
|·||·|||||||·||·
|·||······||·||·
|·||||·||·||·||·
|·||||·||·||·||·
|······||·||·||·
|·||||··········
|·||||·||||||···
|·||||·||||||···
··||||··········
|······||·|||||.
|·||·||||·|HHHHH
|·||·||||·|HHHHH
|·||······|HHHHH
|·||·||||·||||||
|·||·||||·······
|·||·||||·|||···
··||·||···|||···
|·||····|||||···
|·||·||·|||||···
|·||·||·········
|····||||||||||·
|·||·||||||||||·
|·||············
|·||·||||·||||··
|·||·||||·||||··
|·||·||||·||||··
················
|||||·|·||||||||
