
||||||·|||||||||
|···············
|·||||||·||||···
|·||||||·||||···
|·||||||·||||···
|···············
|·||·||||||||||·
|·||·||||||||||·
|···············
|·||||||·||||||·
|·||||||·||||||·
|·||||··········
|······||·|||||.
|·|||·|||·|HHHHH
|·|||·|||·|HHHHH
|·|||·|||·|HHHHH
|·|||·|||·||||||
|······||·······
|·||||·||·||·||·
|·||||····||·||·
|·||||·||·||·||·
|·||||·||·||····
|·||||·||·||·||·
|······||·||·||·
|·|||||||·||·||·
|·|||||||····||·
|·········||·||·
|·|||·||||||·||·
|·|||·||||||·||·
|···············
||||||·|||||||||
