
||·|||||||·|||||
|···············
|·||||||||·||||·
|·||||||||·||||·
|·||·········||·
|·||·||·||||·||·
·····||·||||·||·
|·|||||·||||·||·
|·|||||·||||·||·
|·········||·||·
|·||||·||·||·||·
|·||||·||·······
|·||||·||·|||||.
|·||||····|HHHHH
|·||||·||·|HHHHH
|······||·|HHHHH
|·||||·||·||||||
|·||||·||·······
|·||||·||·|||||·
|·||||·||·|||||·
|·||······|||||·
|····||||·|||||·
|·||·||||·······
|·||·||···|||||·
··||·||·|||||||·
|·||·||·||·||···
|·||·||····||···
|·||·||·||·||···
|·||·||·||·||···
|···············
||·|||||||·|||||
