
||||||||||||||||
|···············
|·|||||·||·||···
|·|||||·||·||···
|·|||||····||···
|·······||·||···
|·|||||·||·||||·
|·|||||·||·||||·
|·|||||·||······
|·|||||·||||||··
|·······||||||··
|·|||||·········
|·|||||||·|||||.
|·||···||·|HHHHH
|·||······|HHHHH
|·||·||||·|HHHHH
|·||·||||·||||||
|·||·||||·······
|·········|||···
|·||||·||·|||···
|·||||·||·|||···
|·||||·||·|||···
|······||·|||···
|·||||·||·|||···
|·||||··········
|·||||·|||||||··
|·||||·|||||||··
|·||||·|||||||··
|·||||·|||||||··
|···············
||||||||||||||||
