
|||||||||||||·||
|···············
|·|||·|||·|||||·
|·|||·|||·|||||·
|·|||·|||·||····
|·|||·||········
|·|||····||||···
|·····||·||||···
|·|||·||·||||···
|·|||·||··|||···
|·|||·|||·|||···
|·|||·|||·······
|·|||·····|||||.
|·|||·|||·|HHHHH
|·····|||·|HHHHH
|·|||·|||·|HHHHH
|·|||·|||·||||||
|·|||···········
|·|||·||||||·||·
|·····||||||·||·
|·|||·||||||·||·
|·|||·||||||·||·
|·||·········||·
|·||·||·|||||||·
|·||·||·|||||||·
|·||·||·········
|····||·||||·||·
|·||·||·||||·||·
|·||·||·||||·||·
|···············
|||||||||||||·||
