
||||||||||||||||
|···············
|·|||||||·|||||·
|·|||||||·|||||·
|·········|||||·
|·||||·||·······
|·||||·||·||||··
|·||||·||·||||··
|·········||||··
|·||·||||·||||··
|·||·||||·||||··
|·····|||·······
|·|||·|||·|||||.
|·|||·····|HHHHH
|·|||||||·|HHHHH
|·|||||||·|HHHHH
|·········||||||
|·|||·|||·······
|·|||·|||·||||··
|······||·||||··
|·||||·||·||||··
|·||||·||·||||··
|·||||·||·······
|·||||·|||·||||·
|·||||·|||·||||·
|·······||·||||·
|·|||||·········
|·|||||·||||||··
|·|||||·||||||··
|···············
||||||||||||||||
