
||||||||||||||||
|···············
|·||·|||·||||||·
··||·|||·||||||·
|·||·|||········
|·||·|||·||·|||·
|·||·|||·||·|||·
|···········||··
|·||||·||||·||··
··||||·||||·||··
|·||||··|||·||··
··||||··········
|·||||·||·|||||.
|······||·|HHHHH
|·|||||||·|HHHHH
|·|||||||·|HHHHH
|······||·||||||
|·||||··········
|·|||||·||·||||·
·····||·||·||||·
|·|||||·||······
··|||||·||·|||··
|·|||||·||·|||··
|·······||·|||··
|·|||||······||·
|·|||||·||||·||·
|·|||||·||||····
··|||||·|||||||·
|·|||||·|||||||·
|···············
||||||||||||||||
