
||||||||||||||||
|···············
|·||||||·|||·||·
|·||||||·|||·||·
|·||·········||·
··||·|||||||·||·
|·||·|||||||·||·
|·||·········||·
|····||||·||····
|·|||||||·|||||·
··|||||||·|||||·
|···············
|·|||||||·|||||.
|·|||||||·|HHHHH
|·|||||||·|HHHHH
|·|||||||·|HHHHH
|·········||||||
|·||||||········
|·||||||·||·|||·
|·····||·||·|||·
··|||····||·|||·
|·||||||·||·|||·
|·||||||·||·····
|·|||····||·||··
|·|||·||·||·||··
··|||·||·||·||··
|···········||··
|·|||||||||·||··
|·|||||||||·||··
|···············
||||||||||||||||
