
||||||||||||||||
|···············
|·||||||·||·|||·
|·||||||·||·|||·
|········||·|||·
|·|||·||·||·||··
|·|||·||·||·||··
|·|||·||·||·||··
|·|||·||·||·||··
|·|||·||·||·||··
|·|||·||·||·||··
|·|||···········
|·····|||·|||||.
|·|||·|||·|HHHHH
|·|||·|||·|HHHHH
|·|||·|||·|HHHHH
|·|||·····||||||
|·|||·|||·······
|·|||·|||·||·||·
|·········||·||·
|·||·||||·||····
|·||·||||····||·
|·||·||||·||·||·
|····||||·|||||·
|·||········|||·
|·||||·||||·····
|·||||·||||·|||·
|·||||·||||·|||·
|·||||·||||·|||·
|···············
||||||||||||||||
