
||||·||||·||||||
|···············
|·|||||·||||||··
|·|||||·||||||··
|·|||||·||||||··
|····||·········
|·||·||·||||||··
|·||·||·||||||··
|·||············
|·||·|||||||·||·
|·||·|||||||·||·
|·||·||||·······
|·||······|||||.
|····||||·|HHHHH
|·|||||||·|HHHHH
|·|||||||·|HHHHH
|·········||||||
|·|||||||·······
|·|||||||··||||·
|·||||·····||||·
|······|||·||||·
|·||·|||||······
|·||·|||||·||||·
|·||·||||··||||·
|·||·||||·|||···
|·||······|||···
|·||·||||·|||···
|·||·||||·|||···
|·||·||||·|||···
|···············
||||·||||·||||||
