
||||||||||||||||
|···············
|·||||·||||·||··
|·||||·||||·||··
|·||||·||||·||··
|·||||·||||·||··
|···········||··
|·|||·|||·||||··
|·|||·|||·||||··
|·|||·|||·||||··
|·|||·|||·||||··
|·|||·|||·······
|·····|||·|||||.
|·|||·····|HHHHH
|·|||||||·|HHHHH
|·|||||||·|HHHHH
|····||||·||||||
|·||············
|·||·|||||||||··
|·||·|||||||||··
|·||······||····
|·||·||||·||·||·
|·||·||||·||·||·
|············||·
|·|||·||||||·||·
|·|||·||||||·||·
|·|||···········
|·|||·||·||||||·
|·|||·||·||||||·
|···············
||||||||||||||||
