
|||·||||||||||||
|···············
··||||||·||||||·
|·||||||·||||||·
|··········||||·
|·|||||·||······
|·|||||·||||||··
|·|||||·||||||··
|···············
|·|||·||||||·||·
|·|||·||||||·||·
|·|||·|||·······
|·|||·|||·|||||.
|·········|HHHHH
|·|||||||·|HHHHH
|·|||||||·|HHHHH
|·········||||||
|·|||||||·······
|·|||||||||·|||·
|········||·|||·
|·||||||····|||·
|·||||||·||·||··
|·····||·||·||··
|·|||····||·||··
|·|||·||·||·||··
|·|||·||·||·||··
|·|||·||·||·····
|·|||·||·||·|||·
··|||·||·||·|||·
|···············
|||·||||||||||||
