
||||||||·|||||||
|···············
|·|||||||·||||··
|·|||||||·||||··
|·········||||··
|·|||||||·||||··
|·|||||||·······
|·|||||||·|||||·
|·|||||||·|||||·
|·········|||||·
··|||||||·|||||·
··|||||||·······
|·········|||||.
|·|||||||·|HHHHH
|·|||||||·|HHHHH
|······||·|HHHHH
|·||||·||·||||||
|·||||··········
|·||||··||·|||··
··||····||·|||··
··||·|||||·|||··
|·||·|||||·|||··
|···············
|·|||||||·|||···
|·|||||||·|||···
|·|||||||·|||···
|······||·|||···
|·||||·||·|||···
|·||||·||·|||···
|···············
||||||||·|||||||
