
|||||||||·||||··
|···············
|·||·||||·|||||·
|·||·||||·|||||·
|·||·||||·||····
··||··|||·||·||·
|·|||·|||·||·||·
|·|||·|||·||·||·
|·········||·||·
|·||·||||·||·||·
|·||·||||·||·||·
|·||·||||·······
|·||·||||·|||||.
|·········|HHHHH
|·||||·||·|HHHHH
|·||||·||·|HHHHH
|·||||·||·||||||
|·|||··||·······
|·|||·|||·|||||·
|·|||·|||·|||||·
|···············
|·||||||·|||·||·
|·||||||·|||·||·
|·|||····|||·||·
|·|||····|||·||·
················
|·||||·|||||||··
|·||||·|||||||··
|·||||·|||||||··
|···············
|||||||||·||||··
