
|||||||||||||||·
|···············
|·||||·||||||···
|·||||·||||||···
|·||||·||||||···
|·||||·||||||···
|·||············
|····||||·||||··
|·|||||||·||||··
|·|||||||·||||··
··········||||··
|·|||||||·······
|·|||||||·|||||.
··········|HHHHH
··||||·||·|HHHHH
|·||||·||·|HHHHH
··||||·||·||||||
··||||·||·······
|·········||·||·
|·||·||||·||·||·
··||·||||·||·||·
|·||·||||·||·||·
|·||·||||·||·||·
|·||······||·||·
|·||·|||||||·||·
|·||·|||||||·||·
|·||············
|·||·||||||·|||·
|·||·||||||·|||·
|···············
|||||||||||||||·
