
||||||||||||||||
|···············
|·|||||||·||||··
|·|||||||·||||··
|·|||||||·||||··
|···············
|·||||·||||||···
|·||||·||||||···
|······||·······
|·||||·||·|||||·
|·||||·||·|||||·
|·||||·||·······
|·||||····|||||.
|······||·|HHHHH
|·|||·|||·|HHHHH
|·|||·|||·|HHHHH
|·|||·|||·||||||
|·|||·|||·······
|·····||||·||···
|·|||·||||·||···
|·|||······||···
|·|||·||||·||···
|·|||·||||·||···
|·|||·||||·||···
|·|||·||||·||···
|··········||···
|·||||||·||||···
|·||||||·||||···
|·||||||·||||···
|···············
||||||||||||||||
