
||||||||·||||||·
|···············
|·||||||||·||||·
··||||||||·||||·
|······||··||···
|·||||·||·|||···
|·||||·||·|||···
|·||||·||·|||···
|···············
|·||||||·||||||·
|·||||||·||||||·
|·||||||········
··||||||··|||||.
|·········|HHHHH
|·|||||||·|HHHHH
|·|||||||·|HHHHH
|·········||||||
|·|||·|||·······
··|||·||||·||||·
|·|||·||||·||||·
|·|||······||||·
|·····||········
|·||||||·||||||·
|·||||||·||||||·
|·||||||····||··
|········||·||··
|·|||||·|||·||··
··|||||·|||·||··
|·|||||·|||·||··
|···············
||||||||·||||||·
