
||·|||||||||||·|
|···············
|·|||·|||·||·||·
|·|||·|||·||·||·
|·|||·|||·||·||·
|·|||·····||·||·
|·····|||·||·||·
|·|||·|||·||·||·
|·|||·|||·||·||·
|·|||·|||·||·||·
|·········||·||·
|·||||·||·······
|·||||·||·|||||.
|·||||·||·|HHHHH
|·||||·||·|HHHHH
|·||||·||·|HHHHH
|·||||·||·||||||
|···············
|·||||||·|||·||·
|·||||||·|||·||·
|········|||·||·
|·||||||·|||·||·
|·||||||·|||·||·
|·||||||·····||·
|·||||||·||||||·
|·||||||·||||||·
|···············
|·|||||||·|||||·
|·|||||||·|||||·
|···············
||·|||||||||||·|
