
||||||||||||||||
|···············
|·|||·|||||·|||·
|·|||·|||||·|||·
|·|||·|||||·|||·
··|||····||·||··
|·|||·||·||·||··
|·|||·||·||·||··
|···········||··
|·||||·||||·||··
|·||||·||||·||··
|·||||·||·······
|·||||·||·|||||.
|·||||·||·|HHHHH
|·||||·||·|HHHHH
|·········|HHHHH
|·|||||||·||||||
|·|||||||·······
|·|||||||·||||··
|·········||||··
|·|||·||·|||||··
|·|||·||·|||||··
|·|||·||·|||||··
|·|||·||·|||||··
|·|||·||········
······||·||||···
|·|||·||·||||···
|·|||·||·||||···
|·|||·||·||||···
|···············
||||||||||||||||
