
||||||||||||||||
|···············
|·|||||||·|||||·
|·|||||||·|||||·
|·|||||||·|||||·
|·|||||||·······
|···········|||·
|·||||·||||·|||·
|·||||·||||·|||·
|·||||··|||·|||·
|·|||||·|||·|||·
|····||·········
|·||·||||·|||||.
|·||·||||·|HHHHH
|·········|HHHHH
|·|||||||·|HHHHH
|·|||||||·||||||
|···············
|·||·|||·||||||·
|·||·|||·||||||·
|·||·|||········
|·····||·||||||·
|·|||····||||||·
|·|||·||·||||···
|·|||·||·||||···
|·|||·||·||||···
|·|||·||········
|·|||·||·||||||·
|·|||·||·||||||·
|···············
||||||||||||||||
