
|||||||||·||||··
|···············
|·|||·||||||·||·
|·|||·||||||·||·
|·|||·||·····||·
··|||·||·|||·||·
|·|||·||·|||·||·
|·········||·||·
|·|||||||·||·||·
|·|||||||·||·||·
|·········||·||·
|·|||·|||·······
|·|||·|||·|||||.
|·|||·|||·|HHHHH
|·|||·|||·|HHHHH
|·········|HHHHH
|·|||·|||·||||||
|·|||·|||·······
|·····||··||·||·
|·||||||·|||·||·
|·||||||·||·····
|·||||||·|||||··
|·||||||·|||||··
|···············
|·|||·||||||·||·
··|||·||||||·||·
|···············
|·||||||·||||||·
|·||||||·||||||·
|···············
|||||||||·||||··
