
||||||||||·|||||
|···············
|·|||||||·||·||·
|·|||||||·||·||·
|············||·
|·|||||||·||·||·
|·|||||||·||·||·
|······||·||·||·
|·||||····||····
|·||||||·||||||·
|·||||||·||||||·
|···············
|·||||·||·|||||.
|·||||·||·|HHHHH
|·||||·||·|HHHHH
|·||||·||·|HHHHH
|·||||·||·||||||
|······||·······
|·||||·||·|||||·
|·||||·||·|||||·
|·||||·||·||····
|·||||·||·||·||·
|·········||·||·
|·|||||||·||·||·
|·|||||||·······
|·|||||||·||||··
|·········|||||·
|·|||||||·|||||·
|·|||||||·|||||·
|···············
||||||||||·|||||
