
||||||·||||·||·|
|···············
|·|||·|||||·|||·
|·|||·|||||·|||·
|·|||·|||||·····
|·|||·|||||·||··
|·|||···|||·||··
|···········||··
|·||··|||||·||··
|·|||·|||||·||··
|·|||·······||··
|·|||·|||·······
|·····|||·|||||.
|·|||·|||·|HHHHH
|·|||·|||·|HHHHH
|·|||·····|HHHHH
|·|||·|||·||||||
|·····|||·······
|·||·||·||·||||·
|·||·|||||·||||·
|·||·|||||······
|·||·······||||·
|····|||||·||||·
|·||·|||||·||||·
|·||·|||||·||||·
|·||·|||||·||||·
|·||············
|·||·||||||||···
|·||·||||||||···
|···············
||||||·||||·||·|
