
||||||·||||||||·
|···············
|·|||||·||||·||·
|·|||||·||||·||·
|·······||||·||·
|·|||||·········
|·|||||·||·|||··
|·|||||·||·|||··
|·|||||····|||··
|·········||||··
|·|||||||·||||··
|·|||||||·······
|·········|||||.
··|||||||·|HHHHH
|·|||||||·|HHHHH
|·········|HHHHH
|·|||·|||·||||||
··|||·|||·······
|·|||·||||·||||·
|·|||·||||·||||·
|·|||·||||·||||·
|··········||||·
|·|||·||||·||||·
|·|||·||||·||||·
|·|||·||||·||||·
|·|||···········
|·····||·||||···
|·||||||·||||···
|·||||||·||||···
|···············
||||||·||||||||·
