
||··||||||||||||
················
|·|||·||·||||···
|·|||·||·||||···
|·|||·||·||||···
|·|||·||·||||···
|·|||·||·|||····
|·|||·||·····||·
|·|||·||·||||||·
|········||||||·
|·||||||·||||||·
|·||||||········
|·|||||||·|||||.
|······||·|HHHHH
|·||||····|HHHHH
|·||||·||·|HHHHH
|·||||·||·||||||
|···············
|·|||||·||||||··
|·|||||·||||||··
|·|||||·||||||··
|·|||||·||||||··
|···············
|·||||·||||||···
|·||||·||||||···
|·|||···········
|·|||·||||||·||·
|·|||·||||||·||·
|·|||·||||||·||·
················
||··||||||||||||
