
||||||||||||||||
|···············
··|||·||||·||||·
|·|||·||||·||||·
|······|||·||||·
|·||||·····||||·
|·||||·|||·|||··
|·||||·|||·|||··
|·······||······
··||||··||·||||·
|·||||··||·||||·
|·||||·||·······
|·||||·||·|||||.
|·········|HHHHH
|·|||·|||·|HHHHH
|·|||·|||·|HHHHH
|·|||·|||·||||||
|·|||·|||·······
|·········||·||·
|·||·|||||||·||·
|·||·|||||||·||·
··||·||||||·····
|·||·||··||·||··
|·||·||··||·||··
|·||········||··
|·|||·||||·||||·
|·|||·||||·||||·
|·|||·||||·||||·
··|||·||||·||||·
|···············
||||||||||||||||
