
|·||·|||·|||||||
|···············
|·|||||·|||·|||·
|·|||||·|||·|||·
|·|||||·|||·····
|·|||||·|||·||··
|·||||··|||·||··
|·||||··|||·||··
|···········||··
|·||||||·||||||·
|·||||||·||||||·
|···············
|·||||·||·|||||.
|·||||·||·|HHHHH
|·||||·||·|HHHHH
|·||||·||·|HHHHH
|·||||·||·||||||
|·||||·||·······
|·········||·||·
|·|||·||||||·||·
|·|||·||||||·||·
|·|||·||||||·||·
|············||·
|·||||||·||·|||·
|·||||||·||·|||·
|····|||·||·····
|·||·|||·||||···
|·||·|||·||||···
|·||·|||·||||···
|···············
|·||·|||·|||||||
