
|||||||||·|·||||
|···············
|·|||||·|||||···
··|||||·|||||···
|·|||||·|||·····
|·|||||·····||··
|····||·|||·||··
|·||·||·|||·||··
|·||·||·|||·||··
|·||····|||·||··
|·||·||·|||·||··
|·||·||·········
······|||·|||||.
··|||·|||·|HHHHH
|·|||·|||·|HHHHH
|·|||·|||·|HHHHH
|·|||·|||·||||||
·······||·······
··||||·||·||||··
|·||||····||||··
|·|||||||·||||··
|·|||||||·||||··
|···············
|·||||||·||||||·
|·||||||·||||||·
|····|||········
|·||·|||·||||···
··||·|||·||||···
|·||·|||·||||···
|···············
|||||||||·|·||||
