
||||||||||||||||
|···············
|·|||||·||||·||·
|·|||||·||||·||·
|·······||||·||·
··|||||·||···||·
|·|||||·||·||||·
|·|||||·||·||||·
|···············
|·|||·|||||||||·
|·|||·|||||||||·
|···············
|·||·||||·|||||.
|·||·||||·|HHHHH
|·||·||||·|HHHHH
|·||·||||·|HHHHH
|·||·||||·||||||
|·||·||·········
|·||·||·||·||||·
|·······||·||||·
|·|||||·||·|||··
|·|||||·||······
|·||||··||·||||·
|·||||·|||·||||·
|······|||······
··||||·····||||·
|·||||·|||·||||·
|·||||·|||·||||·
|·||||·|||·||||·
|···············
||||||||||||||||
