
|·||||||||||||||
|···············
|·||||||·|||·||·
|·||||||·|||·||·
|·||||||·|||·||·
|············||·
|·|||·||||||·||·
|·|||·||||||·||·
|···············
|·||||·||·|||||·
|·||||·||·|||||·
|·||||·||·······
|·||||·||·|||||.
|·||||·||·|HHHHH
|·||||·||·|HHHHH
|·||||·||·|HHHHH
|·||||·||·||||||
|···············
|·|||||···|||||·
|·|||||···|||||·
|·|||||||·|||||·
|·|||||||····||·
|······||·||····
|·||||·||·||·||·
|·||||····||·||·
|·||····||||·||·
|·||·||·||||·||·
|·||·||·||||·||·
|·||·||·||||·||·
|···············
|·||||||||||||||
