
||||||||||||·||·
|···············
|·||||·|||·||||·
|·||||·|||·||||·
|·||||·|||·||||·
|······|||······
|·||||······|||·
|·||||·||||·|||·
|·||||·||||·|||·
|·||····|||·|||·
|····||·|||·|||·
|·|||||·········
|·|||||||·|||||.
|·|||··||·|HHHHH
|·········|HHHHH
|·|||||||·|HHHHH
|·|||||||·||||||
|·|||||·········
|·|||||·||||||··
|·|||||·||||||··
|···············
|·||||||·||·|||·
|·||||||·||·|||·
|·||||||·||·····
|·||||||·|||·||·
|·········||·||·
|·||·||||·||·||·
|·||·||||·||·||·
|·||·||||·||·||·
|···············
||||||||||||·||·
