
||||·|·||||||·||
|···············
··||·|||||||·||·
··||·|||||||·||·
|·||·········||·
|·····||||||·||·
|·|||·||||||·||·
|·|||········||·
|·|||·|||||·····
|·|||·|||||·|||·
|·||····|||·|||·
|····||·········
|·||·||||·|||||.
|·||·||||·|HHHHH
|·||··|||·|HHHHH
|·||··|||·|HHHHH
|·||·||||·||||||
|·||·||·········
|·······|||·|||·
|·|||||||||·|||·
|·|||||||||·|||·
|········||·|||·
|·||||||····|||·
|·||||||·||·|||·
|·||||||·||·····
|········||·|||·
|·||||·||||·|||·
··||||·||||·|||·
··||||·||||·|||·
|···············
||||·|·||||||·||
