
||||||·|||||||||
|···············
··|||·||·|||||··
|·|||·||·|||||··
··|||·||·|||||··
|·|||·||········
|·|||·||·|||·||·
|·|||·||·|||·||·
|·····||·····||·
|·||||||·||||||·
|·||||||·||||||·
|···············
|·||·||||·|||||.
|·||·||||·|HHHHH
|·||·||||·|HHHHH
|·||······|HHHHH
|····||||·||||||
|·|||||||·······
|·|||||||·|||||·
|·|||||||·|||||·
|···············
|·|||||·|||||||·
|·|||||·|||||||·
|·|||||·········
|·|||||·||·||||·
|·······||·||||·
··|||||······||·
|·|||||·||||·||·
··|||||·||||·||·
|···············
||||||·|||||||||
