
||||||||||||||||
|···············
|·|||||·|||·|||·
|·|||||·|||·|||·
|·|||····||·|||·
|·····||||······
|·|||·||||·||||·
|·|||······||||·
··|||·||||·||···
|·|||·||||·||···
|·|||·||||·||···
|·|||···········
|·|||·|||·|||||.
|·····|||·|HHHHH
|·|||·|||·|HHHHH
|·|||·|||·|HHHHH
|·|||·|||·||||||
|·||············
|·||·||·|||·||··
|····||·|||·||··
|·|||||·|||·||··
|·|||||·|||·|||·
········|||·|||·
|·||||·||||·|||·
|·||||·||·······
|·||······|||||·
|·||·||||·|||||·
|·||·||||·|||||·
|·||·||||·|||||·
|···············
||||||||||||||||
