
||·|||||||||||||
|···············
|·||·|||·||·||··
|·||·|||·||·||··
|·||·|||·||·||··
|·||·|||·||·||··
|·||·|||·||·|||·
|·||·|||·||·|||·
|·||············
|·||·||||·|||||·
|····||||·|||||·
|·||·||||·······
|·||·||||·|||||.
|·||·||||·|HHHHH
|·||······|HHHHH
|·|||||||·|HHHHH
|·|||||||·||||||
|···············
|·||·||||·||·||·
|·||·||||·||·||·
|·||·||||·||·||·
|·········||·||·
|·||||·||·||·||·
|·||||·||·||·||·
|·||||·||·||·||·
|·||||·||·||·||·
|···············
|·|||||||||||···
|·|||||||||||···
|···············
||·|||||||||||||
