
|·||||||||||||||
|···············
|·||||||·||||||·
|·||||||·||||||·
|··········|||··
|·|||·||||·|||··
|·|||·||||······
|·|||·||||||·||·
|·|||·||||||·||·
|·········||·||·
|·|||||||·||·||·
|·|||||||·······
··········|||||.
|·|||·|||·|HHHHH
··|||·|||·|HHHHH
|·|||·|||·|HHHHH
··|||·|||·||||||
|·|||·||········
··|||·||·||||···
|·····||·||||···
|·|||·||··|||···
|·|||·····|||···
|·|||·|||·······
|·||··|||||·||··
|······||||·||··
|·||||······||··
|·||||·||||·||··
|·||||·||||·||··
|·||||·||||·||··
|···············
|·||||||||||||||
