
|||||||||||||||·
················
|·||·||·|||||||·
|·||·||·|||||||·
|·||·||·········
|·||·||||||||···
|·||·||||||||···
··||············
|····||·||||||··
|·|||||·||||||··
|·|||||·||||||··
|·||············
|····||||·|||||.
|·||·||||·|HHHHH
|·||·||||·|HHHHH
|·||·||||·|HHHHH
|·||·||||·||||||
|·||············
|·||·|||·||||···
|·||·|||·||||···
|·||·|||·||||···
|·||·|||·|||····
|·||·|||·|||·||·
·········|||·||·
|·||||||·····||·
|·||||||||·||||·
|·||||··||·||||·
|·||||··||·||||·
|·||||··||·||||·
················
|||||||||||||||·
