
||||||||||||||||
|···············
|·|||·||·||||···
|·|||·||·||||···
|·|||····||||···
|·····||·||||···
|·||||||········
|·||||||·|||||··
|········|||||··
|·||||||·|||||··
|·||||||·|||||··
|···············
|·||||·||·|||||.
|·||||·||·|HHHHH
|·||||·||·|HHHHH
|·||||····|HHHHH
|·|||||||·||||||
|·|||||||·······
|·||||····|||||·
|······||·|||||·
|·||||·||·|||||·
|·||||·||·|||||·
|·||||·||·|||||·
|·||||·||·······
|······||·||||··
|·||||····||||··
|·||||||·|||||··
|·||||||·|||||··
|·||||||·|||||··
|···············
||||||||||||||||
