
||||||||||||||||
|···············
|·||·|||||·||···
|·||·|||||·||···
|·||·······||···
|·||·||·||·||···
|·||·||·||·||···
|·||·||·||·||···
|·||·||·||······
|·||·||····||||·
|·||·||||··||||·
|·||·||||·······
|·········|||||.
|·|||||||·|HHHHH
|·|||||||·|HHHHH
|·||···||·|HHHHH
|·||···||·||||||
|·||············
|····||·||||·||·
|·||·||·||||·||·
|·||····||||·||·
|·||·||·||···||·
|·||·||·||·||||·
|·||·||·||·||||·
|·||·||······||·
|·||·||·||||····
|····||·|||||···
|·|||||·|||||···
|·|||||·|||||···
|···············
||||||||||||||||
