
|||·||||·|||||||
|···············
|·|||··||·||||··
|·|||··||·||||··
|·|||··||·||||··
|·|||||||·||||··
|·|||||·········
········||||·||·
|·|||||·||||·||·
|·|||||·||||·||·
|·|||||·||||·||·
|···············
|·|||·|||·|||||.
|·|||·|||·|HHHHH
|·|||·|||·|HHHHH
|·|||·|||·|HHHHH
|·|||·|||·||||||
|·|||···········
|······|||||·||·
|·||||·|||||·||·
|·||||·|||||·||·
|·||||·|||||·||·
|·||||·|||||·||·
·············||·
|·|||·||||||·||·
|·|||·||||||·||·
|·|||·||········
|·|||·||·||||||·
|·|||·||·||||||·
|···············
|||·||||·|||||||
