
||||||||||||||||
|···············
|·||||||·||||···
|·||||||·||||···
|·||||||·||||···
|·||||··········
|······||||||···
|·||||·||||||···
|·||||··········
|·||||·|||||||··
|·||||·|||||||··
··||||··········
·······||·|||||.
|·||||·||·|HHHHH
|·||||·||·|HHHHH
|·||||·||·|HHHHH
|·||||·||·||||||
|···············
··||||||·||||||·
··||||||·||||||·
|·||||||·||||||·
|·||············
|····|||||||·||·
|·||·|||||||·||·
|·||············
|·||·|||||·||||·
|·||·|||||·||||·
|·||·|||||·||||·
|·||·|||||·||||·
|···············
||||||||||||||||
