
|||||||||·||||||
|···············
|·|||||·|||||||·
|·|||||·|||||||·
|·|||||·········
|·|||||·|||||||·
|·······|||||||·
|·|||||······||·
··|||||·||||·||·
|·|||||·||||·||·
|·······||||·||·
|·||·||·········
|·||·||||·|||||.
|·||·||||·|HHHHH
··||·||||·|HHHHH
|·||······|HHHHH
··||·||||·||||||
|····||||·······
|·||·||||··||||·
|·||·||····||||·
|·||····||·||||·
|·||·|||||·||||·
··||·|||||·||||·
|·||············
|·||·||||·|||···
|·||·||||·|||···
|····||||·|||···
|·||·||||·|||···
|·||·||||·|||···
|···············
|||||||||·||||||
