
||||·|·|||·|||||
················
|·||||·||||||···
|·||||·||||||···
|·||||·||·······
|·||||·||·|||···
|·||||·||·|||···
|·||||·||·|||···
|·········|||···
|·||||·||·|||···
|·||||·||·|||···
|·||||·||·······
|·||||·||·|||||.
|·||||····|HHHHH
|······||·|HHHHH
|·|||||||·|HHHHH
|·|||||||·||||||
|····||||·······
|·||·||||·|||||·
|·||······|||||·
|·||||·||·||····
|·||||·||····||·
|·||||·||·|||||·
|·||||·||·||||··
|·||||·||·||||··
|·||||·||·||||··
|··········||···
|·||||||||·||···
|·||||||||·||···
················
||||·|·|||·|||||
