
|||||·||||||||||
|···············
|·|||·|||·||·||·
|·|||·|||·||·||·
|·|||·|||·||····
|·|||·|||·|||||·
|·|||·|||·|||||·
|·····|||·||····
|·||······||·||·
|·||·||||·||·||·
|·||·||||·||·||·
|·||·||||·······
|·||·||||·|||||.
|·||······|HHHHH
|·····|||·|HHHHH
|·|||·|||·|HHHHH
|·|||·|||·||||||
|·||··|||·······
|····||||·||·||·
|·||·||||·||·||·
|·||······||····
|·||···||||||||·
|·||||·||||||||·
|·||||··········
|······||||||||·
|·||||·||||||||·
|·||||·······||·
|·||||·|||||·||·
|·||||·|||||·||·
|···············
|||||·||||||||||
