
||||||||||·||||·
|···············
|·|||||·||·||···
|·|||||·||·||···
|·|||||·||·||···
|·|||||·||·||···
|·|||||·||·||···
|·······||·||···
|·||·|||||·||···
|·||·|||||·||···
|·······||·||···
|·|||||·········
|·|||||||·|||||.
··|||||||·|HHHHH
|·||||····|HHHHH
|······||·|HHHHH
|·|||||||·||||||
··||||||········
|·||||||·||·|||·
|·||||||·||·|||·
|·||||||·||·|||·
|········||·|||·
|·||||||·||·····
|·||||||·||||||·
|········||||||·
|·||||||········
|·||||||·|||||··
|·||||||·|||||··
|·||||||·|||||··
|···············
||||||||||·||||·
