
|||·||··||||||||
|···············
|·|||·|||·|||||·
|·|||·|||·|||||·
|·|||·|||·|||||·
|·|||·······||··
|·|||·|||||·····
|·|||·|||||||||·
|·||····|||||||·
|····||···|||||·
|·|||||||·|||||·
|·|||||||·······
|·········|||||.
|·||·||||·|HHHHH
|·||·||||·|HHHHH
|·||·||||·|HHHHH
|·||·||||·||||||
|·||·||||·······
|·||·||||·|||||·
|·||······|||||·
|·||·||||·||····
|·||·||||····||·
|·||·||||·|||||·
|·||·||···|||||·
|·······|||||||·
|·|||||·|||||||·
|·|||||·········
|·|||||·||||||··
|·|||||·||||||··
|···············
|||·||··||||||||
