
||||||||||||||||
|···············
|·|||||·||||·||·
|·|||||·||||·||·
|·|||||·||||·||·
|·|||||···||·||·
|····||||····||·
··||·||||·|||||·
|·||······|||||·
|·||||·||·|||||·
|·||||·||·|||||·
|······||·······
|·||||·||·|||||.
|·||||·||·|HHHHH
|·||||·||·|HHHHH
|·||||····|HHHHH
|·||||·||·||||||
|·||||·||·······
|·······|||||||·
|·|||||·|||||||·
|·|||||······||·
|·||····||||·||·
|·||·|||||||·||·
··||·|||||||·||·
|···············
|·|||·|||·||||··
|·|||·|||·||||··
|·|||·|||·||||··
|·|||·|||·||||··
|···············
||||||||||||||||
