
|||||||·||||||||
|···············
|·||||·|||·||||·
|·||||·|||·||||·
··||||·|||·||||·
|······|||·||||·
|·||||·|||···||·
|·||||·······||·
|····||||·||·||·
|·||·||||·||·||·
|·||·||||·||·||·
|···············
|·||·||||·|||||.
··||·||||·|HHHHH
|·||·||||·|HHHHH
|·||·||||·|HHHHH
|·||······||||||
··||·||||·······
|····||||·|||···
|·||···||·|||···
|·||||·||·|||···
|·||||·||·|||···
|·||||·||·······
|·|||·····|||···
|·····|||·|||···
|·|||·|||··||···
··|||·||||·||···
|·|||·||||·||···
|·|||·||||·||···
|···············
|||||||·||||||||
