
|·||||||||||||||
················
|·||·|||||·||···
|·||·|||||·||···
|·||·|||||·||···
···········||···
|·|||||·||·|||··
|·|||||·||·|||··
|····||·········
|·||······|||||·
|·||||·||·|||||·
|·||||·||·······
|·||||·||·|||||.
|·||||·||·|HHHHH
|·||||·||·|HHHHH
|·||||·||·|HHHHH
|·········||||||
|·|||||||·······
|·|||||||·|||···
|····||···|||···
|·||·||·|||||···
|·||·||·|||||···
|···············
|·||||||·||||···
|·||||||·||||···
··|||····|||||··
|·|||·||·|||||··
|·|||·||·|||||··
|·|||·||·|||||··
················
|·||||||||||||||
