
|||||||·|||·||||
|···············
··||||·||·||·||·
|·||||·||·||·||·
|·||||·||·||·||·
|······||·||·||·
|·|||||||·||·||·
··|||||||·||·||·
|······||·||····
··||||·||·||·||·
|·||||·||·||·||·
|·||||··········
|······||·|||||.
|·||||·||·|HHHHH
|·||||·||·|HHHHH
|······||·|HHHHH
|·||||·||·||||||
|·||||·||·······
|·||||·||·|||||·
|······||·|||||·
|·||||·||·|||||·
··||||·||·······
|·||||····|||···
··||||·||·|||···
|·||···||··||···
|·||·|||||·||···
|·||·|||||·||···
|·||·|||||·||···
··||·|||||·||···
|···············
|||||||·|||·||||
