
||||||||||||||||
|···············
|·||||·||||·|||·
|·||||·||||·|||·
|·||||·||||·|||·
|·||||······||··
|······||||·||··
|·||||·||||·||··
|·||||·||||·||··
|·||||·||||·||··
|·||||·||||·||··
|·||||·||·······
|·||||·||·|||||.
|·········|HHHHH
|·|||·|||·|HHHHH
|·|||·|||·|HHHHH
|·····|||·||||||
|·|||·|||·······
|·|||·····|||||·
|·|||·||·||||||·
|·||··||·||||||·
|····||·····|||·
|·|||||||||·|||·
|·|||||||||·|||·
|···············
|·||||||·||||···
|·||||||·||||···
|·||||||·||||···
|·||||||·||||···
|···············
||||||||||||||||
