
|·|||·||||||||||
|···············
|·|||||·||||||··
|·|||||·||||||··
|·||············
|·||·||·||·||||·
|····||·||·||||·
|·|||||·||······
|·|||||·||||||··
|····||···||||··
|·||·||||·||||··
|·||·||||·······
|·········|||||.
|·|||||||·|HHHHH
|·|||||||·|HHHHH
|·|||·····|HHHHH
|·|||·|||·||||||
|·····|||·······
|·|||·|||||||||·
|·|||·|||||||||·
|·||············
|·||·||·|||||||·
|····||·|||||||·
|·|||||·····||··
|·|||||··||·||··
|········||·||··
|·||||||·||·||··
|·||||||·||·||··
|·||||||·||·||··
|···············
|·|||·||||||||||
