
||||||||||||||||
|···············
|·||·||·||||||··
|·||·||·||||||··
|·||·||···||||··
|·||·||||·||||··
|·||·||||·|||||·
|···········|||·
··||||·||||·····
|·||||·||||||||·
|·||||·||||||||·
|·||||··········
|·|||··||·|||||.
|·|||·|||·|HHHHH
|·····|||·|HHHHH
|·|||·|||·|HHHHH
|·|||·····||||||
|·|||·|||·······
|·|||·||||·||||·
|·|||·||||·||||·
|·||·······||||·
|·||·||·||···||·
·····||·||||·||·
|·|||||·||||·||·
|·|||||·||||·||·
|···············
|·|||||·||||||··
|·|||||·||||||··
|·|||||·||||||··
|···············
||||||||||||||||
