
||||||||||||||||
|···············
|·||||·||||·|||·
|·||||·||||·|||·
|·||||·||||·|||·
|·||||·||||·|||·
|···········||··
|·|||||||||·····
|·|||||||||·|||·
|·······|||·|||·
|·||·||·|||·|||·
|·||·||·········
|·||··|||·|||||.
|·····|||·|HHHHH
|·|||||||·|HHHHH
|·|||||||·|HHHHH
|·········||||||
|·||||·||·······
|·||||·||||·||··
|·|||····||·||··
|·····||····||··
|·||||||·|||||··
|·||||||·|||||··
|···············
|·||||·||||||||·
|·||||·||||||||·
|·||||··········
|·||||·||||||||·
|·||||·||||||||·
|···············
||||||||||||||||
