
||||||||·|||||||
|···············
|·||||·|||||·||·
|·||||·|||||·||·
|·||||·|||||·||·
|·||||·······||·
········|||||||·
|·|||||·|||||||·
|·|||||·········
|·|||||·||||||··
·····||·||||||··
|·||············
··|||·|||·|||||.
|·|||·|||·|HHHHH
|·|||·|||·|HHHHH
|·|||·|||·|HHHHH
|·····|||·||||||
|·|||·|||·······
··|||·······|||·
|·|||·|||||·|||·
··|||·|||||·|||·
|·······|||·||··
|·||·||·|||·||··
|·||·||·····||··
··||·||||||·||··
|·||·||||||·||··
|·||············
|·||·||||||||||·
|·||·||||||||||·
|···············
||||||||·|||||||
