
|||·||||||||||||
|···············
··||||·||||||···
|·||||·||||||···
|·|||···········
|·|||·||||||·||·
|·|||·||||||·||·
|···············
|·|||·||||·||||·
|·|||·||||·||||·
|·|||·||||·||||·
|···············
|·|||||||·|||||.
··|||||||·|HHHHH
··········|HHHHH
|·|||·|||·|HHHHH
··|||·|||·||||||
··|||·||········
|·|||····||||···
|·||||||·||||···
|·||||||·||||···
|·||·····||||···
|····||·········
|·||·||·||·||||·
|·||·||·||·||||·
|·||·||·||·||||·
|·||·||·||·||||·
|·||·||·||·||||·
··||·||·||·||||·
|···············
|||·||||||||||||
