
||||·|||||||||||
|···············
|·|||·||||||·||·
|·|||·||||||·||·
|···············
|·|||||·||||||··
|·|||||·||||||··
··|||||·········
|·······|||||||·
|·||||·||||||||·
|·||||·||||||||·
|·||||··········
|·||||·||·|||||.
|·||||·||·|HHHHH
|·||||·||·|HHHHH
|·||||·||·|HHHHH
|·||||·||·||||||
|···············
|·||||··|||·|||·
|·||||·||||·|||·
|·||||·||||·|||·
|···········|||·
|·||·|||·||·|||·
··||·|||·||·|||·
|·||·|||·||·|||·
|·||·|||········
|·||·|||·||||···
|·||·|||·||||···
|·||·|||·||||···
|···············
||||·|||||||||||
