
||||||·||||·||||
|···············
|·||·||||||·|||·
|·||·||||||·|||·
|·||············
|·||||·||·|||···
|·||||·||·|||···
|·||||····|||···
|·||||·||·|||···
|······||·|||···
|·||||·||·|||···
|·||||·||·······
|·||||·||·|||||.
|·||||·||·|HHHHH
|·········|HHHHH
|·|||||||·|HHHHH
|·|||||||·||||||
|·||||··········
|······||||·|||·
|·|||·|||||·|||·
|·|||·|||||·|||·
|···········|||·
|·||·||||||·|||·
|·||·||||||·|||·
|···············
|·|||||||·||||··
|·|||||||·||||··
|·|||||||·||||··
|·|||||||·||||··
|···············
||||||·||||·||||
