
||||||||||||||||
|···············
|·||||·||·||·||·
|·||||·||·||·||·
|·||||·||·||·||·
|·||||·|||||·||·
|·······||||·||·
|·|||||······||·
|·|||||·||||·||·
|·|||||·||||·||·
|·······||||·||·
|·|||||·········
|·|||||||·|||||.
|·|||··||·|HHHHH
|·|||·····|HHHHH
|·|||·|||·|HHHHH
|·····|||·||||||
|·|||·|||·······
|·|||·|||·||||··
|·|||·|||·||||··
|·|||·······||··
|·|||·||·||·||··
|·|||·||·||·||··
|········||·|||·
|·||·|||·||·|||·
|·||·|||·||·||··
|·||·|||·||·||··
|·||·|||·||·||··
|·||·|||·||·||··
|···············
||||||||||||||||
