
|||·|||·||||||||
|···············
|·|||·||||||·||·
|·|||·||||||·||·
|············||·
|·||||||·|||·||·
|·||||||·|||·||·
|·········||·||·
|·|||||||·||·||·
|·|||||||·||·||·
|·········||·||·
|·|||·|||·······
|·|||·|||·|||||.
|·|||·|||·|HHHHH
|·|||·|||·|HHHHH
|·|||·|||·|HHHHH
|·|||·|||·||||||
|···············
|·|||||||·||||··
|·|||||||·||||··
|·|||||||·||||··
|·|||||||·······
|·········|||||·
|·||||·||·|||||·
|·||||·||·|||···
|······||·······
|·||·||||·|||||·
|·||·||||·|||||·
|·||·||||·|||||·
|···············
|||·|||·||||||||
