
||||||||||||||||
|···············
|·||·|||·||||···
|·||·|||·||||···
··||·|||·||||···
|·||·|||···||···
|·||·······||···
|·||·||····||···
|····||·········
··|||||·|||||||·
|·|||||·|||||||·
················
|·||·||||·|||||.
|·||·||||·|HHHHH
|····||||·|HHHHH
|·|||||||·|HHHHH
|·||||····||||||
|······||·······
|·||||·||·||||··
··||||·||·||||··
|·||||·||·||||··
··||||·||·······
|·||||·||·||||··
|·||||·||·||||··
|······||·||||··
|·||||·||·······
··||||·||·|||||·
|·||||·||·|||||·
|·||||·||·|||||·
|···············
||||||||||||||||
