
|||·||||||||||||
|···············
|·|||||||·||||··
|·|||||||·||||··
|·||||····||||··
|·||||·||·······
|·||||·||·|||···
··········|||···
|·||||·||·|||···
|·||||·||·|||···
|·||||·||·|||···
|······||·······
|·|||||||·|||||.
|·|||||||·|HHHHH
|·········|HHHHH
|·||·||||·|HHHHH
|·||·||||·||||||
|·||············
|·||·||·|||·||··
|·||·||·|||·||··
|·||·||·|||·||··
|·||·||·|||·||··
|·||·||·|||·||··
··||·||·|||·||··
|···············
|·||||||||·||||·
|·||||||||·||||·
|·||||||||·||||·
|·||||||||·||||·
|···············
|||·||||||||||||
