
||||·||||||·||||
|···············
|·||||||·||||||·
|·||||||·||||||·
|·········|||||·
|·||·||||·|||···
|·||·||||·······
|·||·||||·|||||·
|·||·||||·|||||·
|·||······|||||·
··||·||||·|||||·
··||·||||·······
··||·||||·|||||.
|·||·||||·|HHHHH
|·||·||||·|HHHHH
|·||·||||·|HHHHH
|·········||||||
|·|||||·········
··|||||·||||·||·
··||····||||·||·
··||·||·||||·||·
|·||·||·||||·||·
|·||·||·||···||·
|·||·||·||·||||·
|·······||·||||·
|·|||||······||·
|·|||||·||||····
|·|||||·|||||···
|·|||||·|||||···
|···············
||||·||||||·||||
