
|·||||||||||||||
|···············
|·||||||·||||||·
|·||||||·||||||·
|·||||||·||||||·
|·||||||········
··||·····||||||·
|····|||·||||||·
|·||·|||····||··
|·||·|||·||·||··
|·||·|||·||·||··
··||············
|·||·||||·|||||.
|·||·||||·|HHHHH
|·||·||||·|HHHHH
|·||·||||·|HHHHH
|·||·||||·||||||
|·||·||·········
|·······||·||||·
··|||···||·||||·
|·|||·||||·||||·
|·····||||······
|·|||·||||·|||··
|·|||·||||·||||·
··|||·||||·||||·
|·|||········||·
|·····||||||····
|·|||·|||||||||·
|·|||·|||||||||·
|···············
|·||||||||||||||
