
||||·|||·||||||·
|···············
|·|||||||·||||··
|·|||||||·||||··
|·········||||··
|·|||||||·······
|·|||||||··||||·
|··········||||·
|·||||·|||···||·
|·||||·|||||·||·
··||||·|||||·||·
|·||||·||·······
|·········|||||.
|·|||·|||·|HHHHH
|·|||·|||·|HHHHH
|·|||·|||·|HHHHH
|·|||·|||·||||||
|·····|||·······
|·|||·|||·|||||·
|·|||·||··|||||·
··|||········||·
|·|||·|||·||·||·
|·····|||·||····
|·|||·|||·||·||·
|·|||·|||·||·||·
|·|||·|||·||·||·
|·|||·|||·||·||·
|·|||·|||·||·||·
|·|||·|||·||·||·
|···············
||||·|||·||||||·
