
|·|·||||||||||||
|···············
|·||·||·||·|||··
|·||·||·||·|||··
|····||····|||··
|·||·||·||·|||··
|·||·||·||·|||··
|·||·||·||······
|·||·||·||·||||·
|·||·||·||·||||·
|·||·||·||·||||·
|···············
|·|||·|||·|||||.
|·|||·|||·|HHHHH
|·|||·····|HHHHH
|·|||··||·|HHHHH
|·|||||||·||||||
|·||||||········
|········||||||·
|·||·|||·||||||·
|·||·|||········
|·||·|||·||·|||·
|·||·|||·||·|||·
|·||·|||·||·|||·
|···········|||·
|·||||·||||·|||·
|·||||·||||·····
|·||||·||||·|||·
|·||||·||||·|||·
|···············
|·|·||||||||||||
