
|||||·|·||||·|||
|···············
|·|||||||·|||||·
|·|||||||·|||||·
|··········||···
|·||·|||||·||···
|·||·|||||·||···
|·······||·||···
|·|||||·||·||···
|·|||||·||·||···
|·······||·||···
|·||·||||·······
|·||·||||·|||||.
|·||······|HHHHH
|·||·||||·|HHHHH
|·||·||||·|HHHHH
|·||·||||·||||||
|····||||·······
|·||······|||···
|·|||||||·|||···
|·|||||||··||···
|··········||···
|·||||||···||···
|·||||||·||||···
|·|||····||||···
|·····||········
|·||||||·|||||··
|·||||||·|||||··
|·||||||·|||||··
|···············
|||||·|·||||·|||
