
|||·||||·|||||||
|···············
|·|||||·||||||··
|·|||||·||||||··
|·|||||·········
|·······|||||||·
|·||·||·|||||||·
|·||·||····||···
|·||··||||·||···
|·|||·||||·||···
|·|||·||||·||···
··|||·|||·······
|·········|||||.
|·|||||||·|HHHHH
|·|||||||·|HHHHH
|·|||||||·|HHHHH
|·|||||||·||||||
|···············
|·||·||||||·|||·
··||·||||||·|||·
|·||············
|·|||·|||||·|||·
|·|||·|||||·|||·
|·|||·|||||·||··
|·····|||||·||··
|·|||·||····||··
|·|||·||·||·····
|·|||·||·||||||·
|·|||·||·||||||·
|···············
|||·||||·|||||||
