
|||||||||·||||||
················
|·|||·|||·|||||·
|·|||·|||·|||||·
|·|||·|||·······
|·|||·|||·|||||·
|·····|||·|||||·
|·|||·|||·||····
|·|||·|||····||·
|·|||·····||·||·
|·|||·|||·||·||·
|·····|||·······
|·|||·|||·|||||.
|·|||·|||·|HHHHH
|·|||·|||·|HHHHH
|·|||·····|HHHHH
|·····|||·||||||
|·|||||||·······
|·|||||||·|||||·
|·····||··|||||·
|·|||·||·||||||·
|·|||·||·||||||·
|···············
|·|||||·|||||||·
|·|||||·|||||||·
|·|||||···||····
|·|||||||·||·||·
|·|||||||·||·||·
|·|||||||·||·||·
················
|||||||||·||||||
