
||||||·|||·|||||
|···············
|·|||·|||·||||··
|·|||·|||·||||··
··|||·|||·||||··
|·|||···········
|·|||·||||||·||·
|·····||||||·||·
|·|||···········
|·|||·||||·||||·
··|||·||||·||||·
|·|||·|||·······
··|||·|||·|||||.
|·········|HHHHH
|·|||·|||·|HHHHH
|·|||·|||·|HHHHH
|·|||·|||·||||||
|·|||·|||·······
··········|||···
|·||·||||·|||···
··||·||||·|||···
|·||·||||·|||···
|·||·||||·|||···
|··········|||··
|·||||||||·|||··
|·||||||||······
···········||···
|·|||||·|||||···
|·|||||·|||||···
|···············
||||||·|||·|||||
