
|||||||||||·||||
|···············
|·||·||||·|||||·
|·||·||||·|||||·
|·||·||||·||····
|·||·||||·||·||·
|·········||·||·
|·|||||||·||·||·
|·|||||||·||·||·
··|||||||·||·||·
|·········||·||·
|·|||·|||·······
··|||·|||·|||||.
|······||·|HHHHH
|·||||·||·|HHHHH
|·||||·||·|HHHHH
|·||||·||·||||||
|···············
··||||||·||||||·
|·||||||·||||||·
|········||||···
··|||·||········
|·|||·||·||||||·
|·····||·||||||·
|·||||||········
|·||||||·||||···
|········||||···
|·||||||·||||···
|·||||||·||||···
|···············
|||||||||||·||||
