
|·|||||·|||||·||
|···············
··||||·|||·||||·
|·||||·|||·||||·
|·||||·|||······
|·||||·|||·||||·
|·||||·|||·||||·
|·||||·|||·||···
|······|||·||···
|·||||··||·||···
|·|||||·||·||···
|·||·||·········
··||······|||||.
|·||·||||·|HHHHH
|····||||·|HHHHH
|·||||····|HHHHH
|·||||·||·||||||
|·||||·||·······
··||||·||·||·||·
|······||·||·||·
|·|||||||·||····
|·|||||||·||||··
|···········|||·
|·|||||·|||··||·
|·|||||·||||·||·
|·|||||·||||····
|·||·········||·
|·||·|||||||·||·
··||·|||||||·||·
|···············
|·|||||·|||||·||
