
|·|·||||||||||·|
|···············
|·||||||·|||·||·
|·||||||·|||·||·
|·||||||·····||·
|·||||||·|||·||·
|·||||···|||·||·
|······|||||·||·
|·||||·|||||·||·
|·||||···|||·||·
|·||||||·|||·||·
|·····||········
|·|||·|||·|||||.
|·|||·|||·|HHHHH
|·········|HHHHH
|·||||·||·|HHHHH
|·||||·||·||||||
|·||||··········
|·||||·||||·|||·
|·||||·||||·|||·
|·||||·||||·····
|········||·|||·
|·|||·||····|||·
|·|||·|||||·|||·
|·|||·|||||·|||·
|···············
|·|||||||·|||···
|·|||||||·||||··
|·|||||||·||||··
|···············
|·|·||||||||||·|
