
|·|||||||||·||||
|···············
··|||||·|||·|||·
|·|||||·|||·|||·
··|||||·|||·|||·
|····||·|||·|||·
|·||·||··||·|||·
|·||·····||·||··
|·||···||||·····
|·||||·|||||·||·
··||||····||·||·
|······||·······
|·||||·||·|||||.
|·||||·||·|HHHHH
|······||·|HHHHH
|·||||·||·|HHHHH
|·||||·||·||||||
|·||||··········
|·||||·||·|||||·
|······||·|||||·
··||||||····|||·
|·||||||·||·····
|········||·|||·
|·||||·||||·|||·
|·||||·||||·||··
|·||||··|||·||··
··|||||·|||·||··
|·|||||·|||·||··
··|||||·|||·||··
|···············
|·|||||||||·||||
