
||||||||||||·|||
|···············
|·||||·||·|||||·
|·||||·||·|||||·
|·||||·||·|||||·
|·||||·||·||····
|·||||·||·||·||·
|············||·
|·||·|||||·||||·
|·||·|||||·||||·
|·||····||·||||·
|·||·||·········
|·||·||||·|||||.
|·····|||·|HHHHH
|·|||·|||·|HHHHH
|·|||·····|HHHHH
|·|||·|||·||||||
|·|||·|||·······
|·········|||||·
|·|||||·|||||||·
|·|||||·||······
|·|||||·||·||···
|·|||||····||···
|·······||·||···
|·||||||||·||···
|·||||||||·||···
|·······||·||···
|·|||||·||·||···
|·|||||·||·||···
|···············
||||||||||||·|||
