
||||||||||||||·|
|···············
|·|||||||·||||··
|·|||||||·||||··
··||||····||||··
|······||·······
|·||·||||||·||··
|·||·||||||·||··
············||··
|·|||·||||||||··
|·|||·||||||||··
|·|||···········
|·|||·|||·|||||.
|·····|||·|HHHHH
|·||·||||·|HHHHH
|·||·||||·|HHHHH
|·||·||||·||||||
|···············
|·||||·||·|||||·
|·||||·||·|||||·
|·||||·||·||····
|·||||·||····||·
··········||·||·
|·||·|||··||·||·
|·||·||||·||····
|·||·||||·|||···
··||······|||···
|·||·||||·|||···
|·||·||||·|||···
|···············
||||||||||||||·|
