
||||||||||||||||
|···············
|·|||||·||||·||·
|·|||||·||||·||·
|·|||||·|||·····
|·|||||·|||·||··
|···········||··
|·||||·||·|||···
|·||||·||·|||···
|······||·|||···
|·||||·||·|||···
|·||||·||·······
|·||||·||·|||||.
|·||||····|HHHHH
|······||·|HHHHH
|·|||||||·|HHHHH
|·|||||||·||||||
|·||············
|·||·||·||||·||·
|····||·||||·||·
|·|||||·||||·||·
|·|||||·········
|·······|||||···
|·|||·|||||||···
|·|||·||··|||···
|·|||···········
|·|||·||||·||||·
|·|||·||||·||||·
|·|||·||||·||||·
|···············
||||||||||||||||
