
||||||·|||||||||
|···············
|·||||||||·||···
|·||||||||·||···
|·||||||||·||···
|·····||||·||···
|·|||······||···
|·|||·||||·||···
|·|||·||||·||···
|·|||·||||·||···
|·····||||·||···
|·|||···········
|·||||·||·|||||.
|·||||·||·|HHHHH
|·||||····|HHHHH
|······||·|HHHHH
|·|||||||·||||||
|·|||||·········
|·|||||·||||·||·
|·······||||·||·
|·||·||·||||·||·
|·||·||·||||·||·
|·||············
|·||||·||||·|||·
|·||||·||||·|||·
|·||||·||||·|||·
|············||·
|·|||·||||||·||·
|·|||·||||||·||·
|···············
||||||·|||||||||
