
|||·||||·|||||||
|···············
|·||||||·||·|||·
|·||||||·||·|||·
|·||||||·||·|||·
|·||||||·||·|||·
|···············
|·|||·|||||||···
··|||·|||||||···
|·|||·|||||||···
··|||·|||||||···
|···············
|·|||||||·|||||.
|·|||||||·|HHHHH
|·|||||||·|HHHHH
|·|||||||·|HHHHH
|·····|||·||||||
|·|||···········
|·|||·||||||·||·
|·|||·||||||·||·
··|||·||||||·||·
|·|||·||||||····
··|||········||·
|·····||·|||·||·
|·||||||·|||·||·
|·||||||·|||·||·
|········|||·||·
|·||||||·|||·||·
|·||||||·|||·||·
|···············
|||·||||·|||||||
