
|||||||||||||·||
|···············
|·|||||·||||·||·
|·|||||·||||·||·
|·|||||·||||·||·
|·|||||·||||·||·
|·|||||·········
········||·||···
|·||||·|||·||||·
|·||||·|||·||||·
|······|||·||||·
|·||||·||·······
|·||||·||·|||||.
|·||||·||·|HHHHH
··||||·||·|HHHHH
|·||||·||·|HHHHH
··········||||||
|·|||·|||·······
|·|||·|||||·|||·
|·|||·|||||·|||·
|·|||·|||||·|||·
|·|||·|||||·||··
|···············
··|||·||||·||||·
|·|||·||||·||||·
|·|||·||||······
|·|||·||||·||||·
|·|||·||||·||||·
|·|||·||||·||||·
|···············
|||||||||||||·||
