
||||||||||||||||
|···············
|·||||·||·||·||·
|·||||·||·||·||·
|·||||·||·||·||·
|·||||·||·||·||·
|·||||·||·||·||·
|·||||·||·||·||·
|·||||·||·······
|·||······|||||·
·····||||·|||||·
|·||·||||·······
|·||·||||·|||||.
|·||······|HHHHH
|·||·||||·|HHHHH
|·||·||||·|HHHHH
|·||······||||||
|·····|||·······
|·|||·||||·||···
|·|||·||||·||···
··|||······||···
|·|||·||||·||···
|·|||·||||·||···
|·|||·||||·||···
|·|||·||||······
|·|||·||||·||||·
|··········||||·
|·|||||||·|||||·
|·|||||||·|||||·
|···············
||||||||||||||||
