
||||||||||||||||
|···············
··|||·|||||·|||·
|·|||·|||||·|||·
|·····|||||··||·
|·|||·····||·||·
|·|||·|||·||·||·
|·|||·|||·······
··|||·||||·||||·
|·|||·||||·||||·
|·|||·||||·||||·
|·|||·|||·······
|·········|||||.
|·||·||||·|HHHHH
··||·||||·|HHHHH
|·||·||||·|HHHHH
·····||||·||||||
|·||············
|·|||·||·||·|||·
|·|||·||·||·|||·
|·|||····||·|||·
|·····||·||·|||·
··||||||·||·|||·
|·||||||·||·····
|·····||·||·|||·
|·|||·||·||·|||·
|·|||·||·||·|||·
|·|||·||·||·|||·
··|||·||·||·|||·
|···············
||||||||||||||||
