
||||||||||||||||
|···············
|·|||||||·|||||·
|·|||||||·|||||·
|·|||||·····|||·
|·|||||·|||·|||·
|·······|||·····
|·|||||··||·|||·
|·||||||·||·|||·
|·||||||·||·|||·
|·||||||·||·|||·
|···············
|·|||||||·|||||.
|·|||||||·|HHHHH
|·········|HHHHH
|·|||·|||·|HHHHH
|·|||·|||·||||||
|·|||·|||·······
|·|||·|||·||·||·
|·|||·||··||·||·
|·····||·|||·||·
|·|||·||·|||····
|·|||········||·
|·|||·||||||·||·
|·|||·||||||·||·
|·····||||||·||·
|·|||········||·
|·||||||||||·||·
|·||||||||||·||·
|···············
||||||||||||||||
