
|||||||·|||||||·
|···············
|·|||·||||||·||·
|·|||·||||||·||·
|·|||·||········
|·····||·|||||··
|·|||·||·||||||·
|·|||·||·||||||·
|·|||········||·
|·|||·|||·||·||·
|·|||·|||·||·||·
··|||·|||·······
|·····|||·|||||.
|·|||·····|HHHHH
··||||·||·|HHHHH
|·||||·||·|HHHHH
··||||·||·||||||
|······||·······
|·||||·|||·||||·
··||||··||·||||·
|·|||||····||||·
|·|||||||····||·
|·|||||||·||·||·
|·········||·||·
|·|||·||||||····
|·|||·||||||·||·
|·||·········||·
|·||·|||||||·||·
|·||·|||||||·||·
|···············
|||||||·|||||||·
