
|||||·||·||||·||
|···············
|·|||||·||·||||·
|·|||||·||·||||·
|·|||||·||·||||·
|·|||||·||·||||·
··|||||·||·||···
|·······||·||···
··|||||·||·||···
|·|||||·||·||···
|·|||||·||·||···
|···············
|·||·||||·|||||.
|·||·||||·|HHHHH
|·||·||||·|HHHHH
|·||·||||·|HHHHH
|·||······||||||
|·||·||||·······
|·||·||||·||·||·
|····||···||·||·
|·||·||·||||·||·
|·||·||·||···||·
··||·||·||·||||·
|··········||||·
··||||||||·||···
|·||||||||·||···
|···············
|·||·||||||·|||·
|·||·||||||·|||·
|···············
|||||·||·||||·||
