
||||||||||||||||
|···············
|·||||||||·||···
|·||||||||·||···
|·||||||||·||···
|·||||||||·||||·
|··········||||·
|·||·|||||·||···
|·||·|||||·||···
|·||·||·||·||···
|·||·|||||·||···
|·||·||||·······
|·········|||||.
|·|||||||·|HHHHH
|·|||||||·|HHHHH
|·········|HHHHH
|·||·||||·||||||
|·||·||||·······
|·||······||·||·
|·||·||||·||·||·
|·||·||||····||·
|·||·|||||···||·
|·||·|||||·||||·
|··········||||·
|·||||||||······
|·||||||||·||···
|··········||···
|·||||·||||||···
|·||||·||||||···
|···············
||||||||||||||||
