
|·||||||||||||||
|···············
|·||||·|||||||··
|·||||·|||||||··
|·||||·|||||||··
|···············
|·||·|||·||||||·
|·||·|||·||||||·
|·||············
|·||···||||||···
|·||||·||||||···
|·||||·||·······
|·||||·||·|||||.
|·········|HHHHH
|·|||||||·|HHHHH
|·|||||||·|HHHHH
|·········||||||
|·||||·||·······
|·||||·||||||||·
|·||||·||||||||·
|·||||·||||||||·
|·||||··········
|·······||·||···
|·|||||·||·||···
|·|||||·||·||···
|····||·||·||···
|·||·||·||·||···
|·||·||·||·||···
|·||·||·||·||···
|···············
|·||||||||||||||
