
||||||||||||·|||
|···············
··|||||·||·|||··
|·|||||·||·|||··
|·|||||·||·|||··
··|||||·||·|||··
|·||····||··|||·
|····||||||·|||·
··||·||||||·||··
|·||····|||·||··
|·||·||·|||·||··
|·||·||·········
|·||·||||·|||||.
|·||·||||·|HHHHH
|······||·|HHHHH
|·||||·||·|HHHHH
|·||||····||||||
|·|||||||·······
|·|||||||·||||··
|·········||||··
|·|||||||·||||··
|·|||||||·||||··
··||||||········
|········|||·||·
|·|||·||·|||·||·
··|||·||·|||·||·
|·|||·||··||·||·
|·|||·|||·||·||·
··|||·|||·||·||·
|···············
||||||||||||·|||
