
||||||||·||··||·
|···············
|·||||·|||·||···
|·||||·|||·||···
|·||||·|||·||···
|·|||··|||·||···
|·|||·||···||···
|·|||·||·|||||··
|········|||||··
|·|||·||··||||··
|·|||·|||·||||··
|·····|||·······
|·|||·|||·|||||.
|·|||·····|HHHHH
··|||·|||·|HHHHH
|·|||·|||·|HHHHH
··|||·····||||||
|·|||·|||·······
|·····||||·||||·
|·|||·||||·||||·
|·|||·||||···||·
|·|||·||||||·||·
|·||·····|||····
|·||·|||·····||·
|·||·|||·||||||·
|·||··||·||||||·
|·|||·||········
|·|||·||·||||||·
|·|||·||·||||||·
|···············
||||||||·||··||·
