
|·||·||||||||||·
|···············
|·||||||·||||||·
|·||||||·||||||·
|·||||||·||||||·
|·||||||········
|········||·||··
|·||||·||||·||··
|·||||·||···||··
|·||||·||·||||··
|·········||||··
··|||||||·······
··|||||||·|||||.
|·||||····|HHHHH
|·||||·||·|HHHHH
|·||||·||·|HHHHH
|·········||||||
|·|||||·········
··|||||·||·||||·
··|||||·||·||||·
|·······||·||||·
|·|||||·||······
|·|||||·|||||||·
|·|||||·|||||||·
|···············
|·||||||·||||||·
|·||||||·||||||·
|·||||||·||||||·
|·||||||·||||||·
|···············
|·||·||||||||||·
