
|||||||||||||||·
················
|·||||·||||·|||·
|·||||·||||·|||·
|·||||·||||·||··
|·||||·||||·||··
|·||||·||||·||··
|·||||·||||·····
|·||||·|||||·||·
|·········||·||·
|·|||||||·||·||·
|·|||||||·······
|·····|||·|||||.
|·|||·|||·|HHHHH
··|||·····|HHHHH
|·|||·|||·|HHHHH
··||··|||·||||||
|·||·||||·······
|·||·||||·|||···
|·||·||||·|||···
|·||·||||·|||···
|··········||···
|·||||||||·||···
|·||||||||·||||·
|··········||||·
|·|||||·||······
|·|||||·|||||||·
|·|||||·|||||||·
|·|||||·|||||||·
················
|||||||||||||||·
