
|·|||·||||||||||
|···············
|·||·||·|||||···
|·||·||·|||||···
|····||··||||···
|·||||||·||||···
··||||||········
|·||||||·||·|||·
|········||·|||·
|·|||||||||·|||·
|·|||||||||·|||·
|···············
|·||·||||·|||||.
|·||·||||·|HHHHH
|·||···||·|HHHHH
|·||||·||·|HHHHH
|·||||·||·||||||
|···············
|·|||||·||||||··
|·|||||·||||||··
|·······||||||··
|·|||||·········
|·|||||·|||·||··
|·|||||·|||·||··
··||||······||··
|······||||·|||·
|·||||·||||·|||·
|·||||·||||·|||·
|·||||·||||·|||·
|···············
|·|||·||||||||||
