
||||·||||||||·||
················
|·|||||·||||·||·
|·|||||·||||·||·
|·|||||·||||·||·
|·|||·····||·||·
|·····|||·||·||·
··|||·|||·||·||·
|·|||·|||·······
|·|||·|||·|||||·
|·|||·|||·|||||·
|·|||·|||·······
|·|||·····|||||.
······|||·|HHHHH
|·|||·|||·|HHHHH
|·|||··||·|HHHHH
|·||||·||·||||||
··||||·||·······
|·||||·||·|||||·
|·||||·||·|||||·
|···············
|·|||·||·||||||·
|·|||·||·||||||·
······||·||·····
|·||||||·||·|||·
|·||||||·||·|||·
|·····||·||·|||·
|·|||·||·||·|||·
|·|||·||·||·|||·
················
||||·||||||||·||
