
||||··|||||||||·
|···············
|·|||||·|||||||·
|·|||||·|||||||·
|·|||||·········
|·|||||·||||||··
|·······||||||··
|·|||||·········
|·|||||·|||·|||·
|·|||···|||·|||·
|·|||·|||||·|||·
|·|||·|||·······
|·········|||||.
|·|||||||·|HHHHH
|·|||||||·|HHHHH
|·|||||||·|HHHHH
|·········||||||
|·||||·||·······
|·||||·|||·||||·
|·||||·|||·||||·
|·||||·|||·||||·
|·||||··········
|·||||·|||||||··
|······|||||||··
|·||||··········
|·||||·|||||·||·
|·||···|||||·||·
|·|||·||||||·||·
|·|||·||||||·||·
|···············
||||··|||||||||·
