
|·||||||||||||||
|···············
|·||·|||||||·||·
|·||·|||||||·||·
|·||··||||||·||·
|·|||·||·····||·
|·|||····||||||·
··|||·||·||||||·
··|||·||·||··||·
|·|||·||··||·||·
|·|||·|||·||·||·
|·····|||·······
|·|||·····|||||.
|·|||·|||·|HHHHH
|·||··|||·|HHHHH
|·||·||||·|HHHHH
|·||·||||·||||||
|·||············
|·||·||·|||||||·
|·||·||·|||||||·
|·||·||·|||||||·
|·······||||····
··||·||······||·
··||·||·|||||||·
|····||·|||||||·
|·|||||······||·
|·|||||·||||·||·
|·|||||·||||·||·
|·|||||·||||·||·
|···············
|·||||||||||||||
