
||||||||||·|||||
················
|·|||·||||·|||··
|·|||·||||·|||··
··|||·||||·|||··
|·|||········||·
|·|||·|||·||·||·
|·|||·|||·||····
|·|||·|||·|||···
··········|||···
··||·||||·|||···
|·||·||||·······
|·||·||||·|||||.
|·||·||||·|HHHHH
|·||···||·|HHHHH
|·||||·||·|HHHHH
|·||||·||·||||||
|······||·······
|·||||·||·|||||·
|·||||·||·|||||·
··|||···········
······||·||||||·
|·||||||·||||||·
|·||||||·||||···
|···············
|·||||·||||||···
··||||·||||||···
|·||||·||||||···
|·||||·||||||···
················
||||||||||·|||||
