
|||||||||||·||||
················
|·||·|||·||·|||·
|·||·|||·||·|||·
|·||·|||·||·|||·
|·||·|||·||·|||·
|·||·|||·||·|||·
|·||·····||·|||·
|·||||·||||·····
|·||||·||||·|||·
|·······|||·|||·
|·|||||·········
|·|||||||·|||||.
·······||·|HHHHH
··||||····|HHHHH
|·||||·||·|HHHHH
··||||·||·||||||
··||||··········
|······|||||·||·
|·|||··|||||·||·
|·|||····|||·||·
|·|||·||·|||·||·
|·····||·····||·
|·|||····|||·||·
|·|||||··|||·||·
|·|||||······||·
|·······||||·||·
|·|||||·||||·||·
|·|||||·||||·||·
················
|||||||||||·||||
