
||||||||·|||||||
················
|·||·|||·||·|||·
|·||·|||·||·|||·
|····|||·||·|||·
|·||·|||·||·|||·
|·||·|||·||·|||·
|·||·····||·····
|·||·|||····|||·
|·||·|||||·||||·
|·||·|||||·||||·
|···············
|·|||||||·|||||.
|·|||||||·|HHHHH
··········|HHHHH
|·||·||||·|HHHHH
··||·||||·||||||
|·||·||||·······
|·||·||||·||||··
|·||·||||·||||··
|·||······||||··
|·||·||·||||||··
|·||·||·||··||··
|·||·||·||··||··
|·||·||·||··||··
|·||·||·········
|····||·||||||··
|·|||||·||||||··
|·|||||·||||||··
················
||||||||·|||||||
