
||||||||||||||||
|···············
|·||·||||||||||·
|·||·||||||||||·
|···············
|·||·||||||·||··
|·||·||||||·||··
|·||········||··
|·||·||||·||||··
|·||·||||·||||··
|·||······||||··
|·||·||||·······
|·||·||||·|||||.
|·||·||||·|HHHHH
|·||·||||·|HHHHH
|·||·||||·|HHHHH
|·········||||||
|·|||||·········
|·|||||·||||·||·
|·||····||||·||·
|·||·||·||||·||·
|····||·||||·||·
|·||||·······||·
|·||||·||||·|||·
|······||||·||··
|·||||·||||·····
|·||||······||··
|·||||·|||||||··
|·||||·|||||||··
|···············
||||||||||||||||
