
||·|||||||||||||
|···············
|·|||||||·||||··
|·|||||||·||||··
|·········||||··
|·|||||||·||····
|·|||||||·||·||·
|············||·
··|||||·|||··||·
|·|||||·||||·||·
|·|||||·||||·||·
|···············
|·||·||||·|||||.
|·||·||||·|HHHHH
|·||·||||·|HHHHH
|·····|||·|HHHHH
|·|||·····||||||
|·|||·|||·······
|·|||·|||·|||···
|·|||·||··|||···
|·····||·||||···
|·|||·||·||||···
··|||····|||||··
|·····||····||··
|·|||·||·||·····
|·|||·||·||||···
|·|||·||··||||··
|·|||·|||·||||··
|·|||·|||·||||··
|···············
||·|||||||||||||
