
||||·||||·||||||
|···············
··||||·||||·|||·
|·||||·||||·|||·
|·||||·||||·|||·
|·||||··········
|·||||·|||·||···
|······|||·||···
|·||||·|||·||||·
|·||||·|||·||||·
|·||||·|||·||||·
|·||||·||·······
|·········|||||.
|·|||·|||·|HHHHH
··|||·|||·|HHHHH
|·|||·|||·|HHHHH
··|||·|||·||||||
|·|||·|||·······
|·|||·|||·|||||·
|·········|||||·
|·|||||||·||····
|·|||||||·||·||·
|····||||·||·||·
|·||||··········
|·||||·||||||···
|······||||||···
|·||||··········
|·||||·||||||||·
··||||·||||||||·
|···············
||||·||||·||||||
