
||··|·||||||||||
|···············
··||||·||·||||··
|·||||·||·||||··
|·||||·||·||||··
|·||||·||·||||··
|·||||·||·······
|·||||·||·||||··
|·||||····||||··
|·||||·||·||||··
|······||·||||··
|·|||·|||·······
|·|||·|||·|||||.
|·|||·|||·|HHHHH
|·|||·····|HHHHH
|·|||·|||·|HHHHH
|·|||·|||·||||||
|···············
|·||·||··|||·||·
|·||·||··|||·||·
|·||·|||·····||·
|·||·|||·|||·||·
|·||·|||·|||·||·
|·||·|||·|||·||·
|·········||·||·
|·||||·||····||·
|·||||·|||||·||·
|·||||·|||||·||·
··||||·|||||·||·
|···············
||··|·||||||||||
