
||||||||||||||·|
|···············
|·|||·||||·||···
|·|||·||||·||···
··|||·||||·||···
|·····||||·||···
|·|||······||···
|·|||·||·||||···
··|||·||·||||···
|·|||·||·||||···
|·········|||···
|·|||·|||·······
|·|||·|||·|||||.
··|||·|||·|HHHHH
|·|||·|||·|HHHHH
|·|||·|||·|HHHHH
|·|||·|||·||||||
··||············
|·||·||||·||·||·
|····||||·||·||·
|·||·||||·||·||·
|·||······||····
··||·||||·|||···
|·||·||||·|||···
|·||·||·········
|·||·||·||·||||·
········||·||||·
|·||·|||||·||||·
|·||·|||||·||||·
|···············
||||||||||||||·|
