
||||||||||||||||
|···············
|·|||·||||·||||·
|·|||·||||·||||·
|·|||·||||·||···
|·|||·||||·||···
|·|||·||||·||···
|·····||||·||···
|·|||······||···
|·|||···||·||···
|·||||||||·||···
|·|||||||·······
|·········|||||.
|·||·||||·|HHHHH
|·||·||||·|HHHHH
|·||·||||·|HHHHH
|····||||·||||||
|·|||||·········
|·|||||·|||·|||·
|·······|||·|||·
|·|||·|||||·|||·
|·|||·|||||·|||·
|·|||·||········
|·|||·||·||||···
|·|||·||·||||···
|·|||····|||||··
|·|||·||·|||||··
|·|||·||·|||||··
|·|||·||·|||||··
|···············
||||||||||||||||
