
|·|||||·|·||||||
|···············
|·||||·||·|||||·
··||||·||·|||||·
|·||||·||···|||·
|·||||·||||·|||·
·······||||·····
|·||||······|||·
|·||||·||·|||||·
|·|||··||·|||||·
|·····|||·|||||·
|·|||·|||·······
|·|||·|||·|||||.
|·|||·|||·|HHHHH
|·||··|||·|HHHHH
|·||·||||·|HHHHH
|····||||·||||||
|·||···||·······
|·||||·||·||·||·
|·||||····||·||·
|·||||·||·||·||·
|······||·||····
|·||||·||·||||··
|·||||·||·||||··
··||||·||·||||··
|·||||·||·||||··
|·||||··········
··|||||·||||||··
|·|||||·||||||··
|···············
|·|||||·|·||||||
