
|||||||||||·||||
|···············
|·|||||||||·||··
|·|||||||||·||··
|···········||··
|·||·||||||·||··
|·||·||||||·|||·
|···········|||·
|·|||||||||·····
|·|||||||||·|||·
|·······|||·|||·
··||||··········
|·||||·||·|||||.
|·||||·||·|HHHHH
··||||·||·|HHHHH
|······||·|HHHHH
··||||·||·||||||
|·||||·||·······
|·||||·||··||||·
··||||·····||||·
|······|||·||||·
|·||||·|||·||||·
|·||||··||······
|····||·||·||···
|····||·||·||···
|·|||||····||···
|·||||||·||||···
|·||||||·||||···
|·||||||·||||···
|···············
|||||||||||·||||
