
||||||||||||||||
|···············
|·|||||·||||·||·
|·|||||·||||·||·
|·······||||·||·
|·|||||·········
|·|||||·||||||··
|·|||||·||||||··
|···············
|·||||||·||||||·
|·||||||·||||||·
|·||············
|····||||·|||||.
|·|||||||·|HHHHH
|·|||||||·|HHHHH
|·········|HHHHH
|·|||·|||·||||||
|·|||·|||·······
|·|||·|||·||·||·
|·|||·|||·||·||·
|·|||·|||·||·||·
|·|||·|||·||·||·
|·········||·||·
|·||||||·||··||·
|·||||||·||·|||·
|···········|||·
|·||·||||||·|||·
|·||·||||||·|||·
|·||·||||||·|||·
|···············
||||||||||||||||
