
|||||||||·||||||
|···············
··||·||·||·||||·
|·||·||·||·||||·
|·||·||······||·
|·||·||·||||·||·
|·||·||·||||·||·
|·||·||·········
········||·||||·
|·||||·|||·||||·
|·||||·|||·||||·
|·||||·||·······
|·|||·····|||||.
|·|||·|||·|HHHHH
|·||··|||·|HHHHH
|·||·||||·|HHHHH
|····||||·||||||
|·||·|||········
|·||·|||·||||||·
|·||·|||·||||||·
|·||·········||·
|·||·||||·||·||·
··||·||||·||·||·
|······||·||·||·
|·||||·|||||····
|·||||···|||·||·
|·||||||·····||·
|·||||||·||||||·
··||||||·||||||·
|···············
|||||||||·||||||
