
||·|||||||||||||
|···············
|·||·||·||·||||·
|·||·||·||·||||·
|·||·||·||·||||·
|·||·||·||·||||·
|····||······||·
|·||·||·||||·||·
|·||·||·||||·||·
|·||······||·||·
|·||·||||·||·||·
|·||·||||·······
|·||·||||·|||||.
|······||·|HHHHH
|·||||·||·|HHHHH
|·||||····|HHHHH
|·|||||||·||||||
|·|||||||·······
|···········||··
|·|||||||||·||··
|·|||||||||·||··
|·|||||||||·||··
|·|||||||||·||··
|···········||··
|·||||||·||·||··
|·||||||·||·····
|·····||·||||||·
|·|||·||·||||||·
|·|||·||·||||||·
|···············
||·|||||||||||||
