
||||||||||||·|||
|···············
|·|||||·|||·|||·
··|||||·|||·|||·
|·|||||·|||·····
|·······||||||··
|·||||··||||||··
|·||||··········
··||||·|||||·||·
|·||||·|||||·||·
·······|||||·||·
|·||||··········
|·|||||||·|||||.
··|||||||·|HHHHH
|·········|HHHHH
|·|||||||·|HHHHH
|·|||||||·||||||
······|||·······
|·|||·|||·|||||·
|·|||·····|||||·
··|||·|||·||····
|·|||·|||·||·||·
··|||·|||·||·||·
|·|||·|||·||·||·
|······||·||·||·
|·||||·······||·
|·||||·|||||·||·
··||||·|||||·||·
|·||||·|||||·||·
|···············
||||||||||||·|||
