
||||||||||||||||
|···············
|·||||·|||·||||·
··||||·|||·||||·
|·||||·|||·||||·
|·||||·|||·||||·
|·······||······
|·||·||·||·|||··
|·||·||····|||··
|·||·||···||||··
|·||·||||·||||··
|·||·||||·······
|·········|||||.
|·||||·||·|HHHHH
|·||||·||·|HHHHH
|·||||·||·|HHHHH
|·||||·||·||||||
|·||||··········
|·||||·|||·||||·
|······|||·||||·
|·||||··||··|||·
|·|||||·|||·····
|·|||||·|||·||··
|···········||··
|·||·||||||·||··
|·||·||||||·||··
|···········||··
··||||||·||·||··
|·||||||·||·||··
|···············
||||||||||||||||
