
||||||||||||||||
|···············
|·|||||·||||·||·
|·|||||·||||·||·
|·|||||·||||·||·
················
|·||||||·|||||··
|·||||||·|||||··
|·||||||·||·····
|·········||·||·
··|||||||·||·||·
··|||||||·······
|······||·|||||.
|·||||·||·|HHHHH
··||||·||·|HHHHH
|·||||·||·|HHHHH
··||||·||·||||||
|···············
|·||||||·||||||·
··||||||·||||||·
··||||||·||||||·
|·||||||········
|········||·|||·
|·|||||·|||·|||·
|·|||||·||··|||·
········|||·||··
|·|||||·|||·····
|·|||||·|||·|||·
|·|||||·|||·|||·
|···············
||||||||||||||||
