
|·||||||||||||||
|···············
|·||·||||||||||·
··||·||||||||||·
|····||||·······
|·||·······||||·
|·||·|||||·||||·
|·||·|||||·|||··
|·||·|||||·|||··
|·||····||·|||··
|·||····||·|||··
················
|·|||·|||·|||||.
|·|||·|||·|HHHHH
|·|||·|||·|HHHHH
|·|||·|||·|HHHHH
|·|||·|||·||||||
|···············
|·|||||||·||·||·
··|||||||·||·||·
|·········||·||·
|·||·||||·||·||·
|·||·||||·||·||·
|·||·||||·||·||·
|·||······||·||·
|·||·||||····||·
|·||·||||·||·||·
··||·||||·||·||·
|·||·||||·||·||·
|···············
|·||||||||||||||
