
|||||||||||||·||
|···············
|·|||||·|||||···
|·|||||·|||||···
|·||····|||||···
|·||·||·|||||···
|····||·········
··||·||·||||||··
|·||·||·||||||··
··||·||·||||||··
|·||·||·||||||··
|·||············
|·||·||||·|||||.
|·||·||||·|HHHHH
|·||·||||·|HHHHH
|·||·||||·|HHHHH
|·||·||||·||||||
|···············
|·||||·||||||||·
|·||||·||||||||·
|·||||·····||···
··||||·|||·||···
|·||||·|||·||···
·······|||······
|·||||·····||||·
|·||||·|||·||||·
|·||||·|||··||··
|·||||·||||·||··
|·||||·||||·||··
|···············
|||||||||||||·||
