
||||||||||||||||
|···············
|·||·||·||||·||·
|·||·||·||||·||·
|·||·||·||||·||·
|·||·||·||||·||·
|·||·||······||·
|·||·||·|||||||·
|····||·|||||||·
|·||······|||||·
|·||·||||·|||||·
|·||·||||·······
|·||·||||·|||||.
|·||··|||·|HHHHH
|·||··|||·|HHHHH
|·········|HHHHH
|·||·||||·||||||
|·||·||||·······
|·||·||····||···
|·||·||····||···
|·||·||····||···
|····|||||·||···
|·||·|||||·||···
|·||·||····||||·
|·||····||·||||·
|·||||·|||·||···
|·||||·|||·||···
|·||||·|||·||···
|·||||·|||·||···
|···············
||||||||||||||||
