
|·|·|||||||·||||
|···············
|·||||||·|||||··
|·||||||·|||||··
|·||||||·||||···
|···············
|·|||·||·||·|||·
|·|||·||·||·|||·
|·|||····||·|||·
|·|||·|||||·|||·
|·|||·|||||·|||·
|·|||·|||·······
··········|||||.
|·||·||||·|HHHHH
|·||·||||·|HHHHH
|·||·||||·|HHHHH
|·||·||||·||||||
|·||············
··||·|||||·||···
|····|||||·||···
|·||||||||·||···
|·||||||||·||···
|··········||···
|·||||·||||||···
|·||||·||||||···
|·||············
|····|||||·||||·
|·||||||||·||||·
|·||||||||·||||·
|···············
|·|·|||||||·||||
