
|||·||||·|||||||
|···············
|·||·||||||·|||·
|·||·||||||·|||·
|·||·||······||·
·····||·||||·||·
|·||·||·||||·||·
··||·||·||||·||·
|·||············
|·||||·||·|||||·
|·||||·||·|||||·
|·||||·||·······
··||||·||·|||||.
|·||||·||·|HHHHH
|······||·|HHHHH
|·||||·||·|HHHHH
|·||||·||·||||||
|·||||·||·······
·······||·|||||·
|·||||·||·|||||·
|·||||····||····
|····|||········
|·||·|||·||||···
··||·····||||···
|·||·|||·||||···
··||·|||·||||···
|·||·|||········
|·||·|||·||||||·
|·||·|||·||||||·
|···············
|||·||||·|||||||
