
||||||||||||||||
|···············
|·|||·|||||·|||·
|·|||·|||||·|||·
|·····||||······
|·|||·||||·||···
|·|||······||···
|·||||||·|||····
|·||||||·|||||··
|·········||||··
|·|||||||·||||··
|·|||||||·······
|·||||····|||||.
|·||||·||·|HHHHH
··||||·||·|HHHHH
|······||·|HHHHH
··||||·||·||||||
|·||||·||·······
|·||||·||·|||···
|·||···||·|||···
|·||·||||·|||···
|·||·||||·|||···
|·||·||·········
|·······||||||··
|·||||·|||||||··
|·||||·|||||||··
|·||||··········
|·||||·||||||||·
|·||||·||||||||·
|···············
||||||||||||||||
