
||||||||||||||||
|···············
|·|||·||·||||···
|·|||·||·||||···
|·|||·||·||||···
|·|||······||···
··|||·||||·||···
|·|||·||||·||···
|···············
|·||||||·||||||·
|·||||||·||||||·
|···············
|·||||·||·|||||.
|·||||·||·|HHHHH
|·||||····|HHHHH
|·||···||·|HHHHH
|·||·||||·||||||
|····|||········
|·||·|||·||||||·
|·||·|||·||||||·
|·||·|||·||||||·
|·||··||·||||||·
|·|||···········
|·|||·||·|||·||·
······||·|||·||·
|·|||·||·|||·||·
|·|||·||·||··||·
|·|||·||·||·|||·
|·|||·||·||·|||·
|···············
||||||||||||||||
