
||||||||||||||||
················
|·|||·||||||·||·
|·|||·||||||·||·
|·|||·|||·······
······|||·|||···
··|||·····|||···
|·||||·||··||···
|·||||·|||·||···
|·||····||·||···
|····|||||·||···
|·||·||||·······
|·||·||||·|||||.
|·||·||||·|HHHHH
··········|HHHHH
|·|||||||·|HHHHH
··|||||||·||||||
|·|||||·········
|·|||···|||·|||·
|·····|||||·|||·
|·|||·|||||·|||·
|·|||·||········
|·|||·||·||||···
|·|||·||·||||···
··||·····||||||·
··||·|||·||||||·
|·||·|||···||···
|·||·|||||·||···
|·||·|||||·||···
················
||||||||||||||||
