
||||||·|||||||||
|···············
|·|||||·||||·||·
|·|||||·||||·||·
|·······||||····
|·|||||·||||·||·
··|||||·||||·||·
|·|||||·||||·||·
|············||·
|·||||||·||||||·
|·||||||·||||||·
|···············
|·||||·||·|||||.
··||||·||·|HHHHH
|·||||·||·|HHHHH
|·||||·||·|HHHHH
|······||·||||||
··||||·||·······
|·||||····||||··
|·|||||||·||||··
|·|||||||·||||··
|···············
|·||·||||||·|||·
|·||·||||||·|||·
··||·||||||·····
|·||·||||||·|||·
|·||········|||·
|·||·||||||·|||·
|·||·||||||·|||·
|···············
||||||·|||||||||
