
||||||||||||||||
|···············
|·||||||||||·||·
|·||||||||||·||·
|······||||·····
|·||||·||||·|||·
|·||||······|||·
|·||||·||||·||··
|·||||·||||·||··
|·······|||·||··
|·||·||·|||·||··
|·||·||·········
|·||·||||·|||||.
|·||·||||·|HHHHH
|·||·||||·|HHHHH
|·||·||||·|HHHHH
|····||||·||||||
|·||·||·········
|·||·||·||||·||·
|·······||||·||·
|·|||||·||||·||·
|·|||||·||||·||·
|·|||||·········
|·······||||·||·
|·|||||·||||·||·
|·|||||···||·||·
|·|||||||·||·||·
|·|||||||·||·||·
|·|||||||·||·||·
|···············
||||||||||||||||
