
||||||||||||||||
|···············
|·|||||·||·||···
|·|||||·||·||···
|·|||||·||·||···
|·······||·||||·
|·||||·|||·||||·
|·||||·|||······
|·||||·|||·||||·
|·||||·|||·||||·
|·||···|||·||||·
|·||············
|·||·||||·|||||.
|····||||·|HHHHH
|·||·||||·|HHHHH
|·||·||||·|HHHHH
|·····|||·||||||
|·|||·|||·······
|·|||·|||·||||··
|·|||·||··||||··
|·|||·||··||||··
|·········||||··
|·||||·||·······
|·||||·||·|||||·
|·||||·||·|||||·
|·||||·||·||····
|·||||·||····||·
|·||||·||·|||||·
|·||||·||·|||||·
|···············
||||||||||||||||
