
|||||||||||||·||
|···············
|·||||·||||||···
|·||||·||||||···
|·||||··········
|·||||||·||||||·
··||||||·||||||·
|·||||||········
|·||||||·||||···
|·||||||·||||···
|········||||···
··||||||········
|·|||||||·|||||.
|····||||·|HHHHH
|·||·||||·|HHHHH
|·||·||||·|HHHHH
|·||······||||||
|·||·||||·······
|·||·||||·||·||·
··||·||···||·||·
|·||·||·||||·||·
|·||·||·||||·||·
|········|||·||·
|·|||·||·····||·
··|||·||||||····
|·|||·||||||·||·
|·|||·····||·||·
|·|||·|||·||·||·
|·|||·|||·||·||·
|···············
|||||||||||||·||
