
||||||||||||||||
|···············
|·||||·||·|||||·
|·||||·||·|||||·
|······||·······
|·|||||||||·|||·
|·|||||||||·|||·
|···············
|·|||||||·|||···
|·|||||||·|||||·
··········|||||·
|·|||||||·······
|·|||||||·|||||.
|·||||····|HHHHH
|······||·|HHHHH
|·||·||||·|HHHHH
|·||·||||·||||||
|·||·||||·······
|····||||·||·||·
|·|||||||·||·||·
··|||||||·||·||·
|············||·
|·||||·|||||·||·
|·||||·|||||·||·
|·||||·|||||·||·
|·||||·|||||·||·
|···············
|·||||||·||||||·
|·||||||·||||||·
|···············
||||||||||||||||
