
||||·|||·|||||||
|···············
|·||·|||·||||||·
··||·|||·||||||·
|·||·|||····||··
|·||·|||·||·||··
|·||·|||·||·||··
|···············
|·|||||||·||||··
|·|||||||·||||··
|·········||||··
··||·||||·······
|·||·||||·|||||.
··||·||||·|HHHHH
|·········|HHHHH
|·|||··||·|HHHHH
|·|||||||·||||||
··|||||·········
|·|||||·||·||···
········||·||···
|·||·|||||·||···
|·||·|||||·||···
|····||····||···
|·||·||·||·||···
|·||·||·||·||···
|·||·||·||·||···
|·||············
··||·||||||||||·
|·||·||||||||||·
|···············
||||·|||·|||||||
