
||||||||||||||||
|···············
··|||·||||·||···
··|||·||||·||···
|·|||·||||·||···
|·|||··|||·|||··
|·||||·|||·|||··
|·||||·|||·|||··
|···············
|·||·||||||||||·
|·||·||||||||||·
|···············
|·|||||||·|||||.
|·|||||||·|HHHHH
|·········|HHHHH
|·|||·|||·|HHHHH
|·|||·|||·||||||
|·····|||·······
|·|||·|||·||||··
|·|||·||··||||··
|·|||·||·|||||··
|·|||·||·||·····
|···········|||·
|·||||·||||·|||·
|·||||·||||·····
|·||||·||||·|||·
|·||||·||||·|||·
··||||·||||·|||·
··||||·||||·|||·
|···············
||||||||||||||||
