
|||||||||||||·||
|···············
|·||||·||||·|||·
|·||||·||||·|||·
|·||||·||||·|||·
|·||||··········
|······||||·|||·
|·||||·||||·|||·
|·||||···||·|||·
|·||·····||·|||·
··||·|||·||·|||·
|·||·|||········
|·||·||||·|||||.
|·||·||||·|HHHHH
|·········|HHHHH
|·||·||||·|HHHHH
|·||·||||·||||||
|·||·||||·······
|·········|||||·
|·|||||||·|||||·
··|||||||·|||||·
|·||||····|||||·
|······||·||····
|·|||||||····||·
|·|||||||·||·||·
|·|||·····||·||·
|·····||·····||·
|·||||||||||·||·
|·||||||||||·||·
|···············
|||||||||||||·||
