
||||||·|||·|||·|
|···············
|·||||·||||·|||·
|·||||·||||·|||·
|·||||·||||·|||·
················
|·|||·||||||||··
|·|||·||||||||··
|·|||···||······
|·|||||·||·||||·
|·|||||·||·||||·
|···············
|·||·||||·|||||.
|·||·||||·|HHHHH
|·||·||||·|HHHHH
|·||······|HHHHH
|·|||·|||·||||||
|·|||·|||·······
|·|||·|||·||·||·
|·|||·||··||·||·
|·|||·||·||··||·
|········||·|||·
|·||||·|||··|||·
|·||||·|||······
|·||||·||||||···
·······||||||···
|·||||··········
|·||||·|||||||··
|·||||·|||||||··
|···············
||||||·|||·|||·|
