
||||||||||||||||
|···············
|·|||·||||·||||·
|·|||·||||·||||·
|·|||·||||······
|··········|||··
|·||||·||·||||··
|·||||·||·||||··
|·||||·||·||||··
|·||||·||·||||··
|·||||·||·||||··
·······||·······
|·||||····|||||.
|·||||·||·|HHHHH
|·||||·||·|HHHHH
|·||||·||·|HHHHH
|·||||·||·||||||
|·||||·||·······
|······|||·||||·
··||·|||||·||||·
|·||·|||||·||||·
|·||·|||||·||||·
|·||············
|·||·||·||||·||·
|·||·||·||||·||·
|·||·||·||···||·
|····||·||·||||·
|·||·||·||·||||·
|·||·||·||·||||·
|···············
||||||||||||||||
