
||·|||||||||||||
|···············
|·||·||·||·||||·
|·||·||·||·||||·
|·||·||·||···||·
|·||·||·||||·||·
|·||·||·||||·||·
|·||·||·········
|·||······|||||·
|····||||·|||||·
|·||·||||·|||||·
|·||·||||·······
|·||·||||·|||||.
|·||·||||·|HHHHH
|·||·||||·|HHHHH
|·||······|HHHHH
|·||·||||·||||||
|·||·||||·······
|·||·||||·|||||·
|·||·||||·|||||·
|·||·||||·||····
|············||·
|·||||||·||||||·
|·||||||·||||||·
|···············
|·|||·||||·|||··
|·|||·||||·|||··
|·|||·||||·||||·
|·|||·||||·||||·
|···············
||·|||||||||||||
