
||·||||||||||||·
|···············
|·|||||·||||·||·
|·|||||·||||·||·
|·|||||·||||····
|····||·||||·||·
|·||||·······||·
|·||||·|||||·||·
|······|||||·||·
|·||||·|||||·||·
|·||||·|||||·||·
|·||||··········
|·||||·||·|||||.
|······||·|HHHHH
|·||||·||·|HHHHH
|·||||·||·|HHHHH
|·||||·||·||||||
|······||·······
|·||||····||·||·
|·||||·|||||·||·
|·||||·||||·····
|······||||·||··
|·||||·||||·||··
|·||||······||··
|·||||·|||·|||··
|······|||·||||·
|·||||·|||·||||·
|·||||·|||·||||·
|·||||·|||·||||·
|···············
||·||||||||||||·
