
||||··|·||||||||
|···············
|·|||·||·||||||·
|·|||·||·||||||·
|·|||·||·||||||·
|·|||···········
|·|||·||||||·||·
|·|||·||||||·||·
|·|||···········
|·····|||·|||||·
|·||·||||·|||||·
|·||·||||·······
|·||·||||·|||||.
|·||·||||·|HHHHH
|·········|HHHHH
|·|||||||·|HHHHH
|·|||||||·||||||
|···············
|·||||·||||·|||·
|·||||·||||·|||·
|·||||·||||·||··
|·||||·||||·||··
|···········||··
|·||||||·||·||··
|·||||||·||·||··
|···········||··
|·||||·||||·||··
|·||||·||||·||··
|·||||·||||·||··
|···············
||||··|·||||||||
