
|·||||·|||||||||
|···············
|·||||||·||||||·
|·||||||·||||||·
|·||············
|·||·|||||·|||··
|·||·|||||·|||··
|·||·|||||·|||··
|····|||||·|||··
··||····||·|||··
|·|||||·||·|||··
|·|||||·········
|·|||||||·|||||.
|······||·|HHHHH
|·||||·||·|HHHHH
|·||||·||·|HHHHH
|·||||····||||||
|·|||||·········
|·|||||·||·||||·
|·······||·||||·
|·|||·||||·||||·
··|||·||||·||||·
|·|||·||·····||·
|········|||·||·
|·||||·|||||····
|·||||·||·||||··
|·||||····||||··
|·||||·||·||||··
|·||||·||·||||··
|···············
|·||||·|||||||||
