
||·|||||||||||||
|···············
|·||||·||||||···
|·||||·||||||···
|·||············
··||·|||||·||···
|·||·|||||·||···
|·||·|||||·||···
|·||·|||||·|||··
|······|||·|||··
|·||||·|||·|||··
|·||||··········
··||||·||·|||||.
··||||·||·|HHHHH
··········|HHHHH
|·|||·|||·|HHHHH
··|||·|||·||||||
··|||·|||·······
······|||·|||||·
|·|||·||··|||||·
|·|||····||||||·
|·|||····||||||·
|·|||···········
|·······||||·||·
|·|||||·||||·||·
··|||||·||···||·
|····||·||·||||·
|·||·||·||·||||·
|·||·||·||·||||·
|···············
||·|||||||||||||
