
|·||··||||||||||
················
|·|||||·||·||···
|·|||||·||·||···
|·|||||·||·||···
|·|||||·||·||···
|·|||||·||·||···
|··········||···
|·||||||||·||···
|·||||||||·||···
|·||||||||·||···
|·|||||||·······
|·········|||||.
|·||·||||·|HHHHH
··||·||||·|HHHHH
|·||·||||·|HHHHH
··||·||||·||||||
|···············
|·||||||||·||||·
|·||||||||·||||·
|····||||··||···
|·||·||||·|||···
|·||······|||···
|·||||·||·|||···
|·||||·||·······
|·||||·||·|||||·
|······||·|||||·
|·||||·||·|||||·
|·||||·||·|||||·
················
|·||··||||||||||
