
|||||||·|·||||||
|···············
|·||·||||·|||||·
|·||·||||·|||||·
|·||·||||·|||||·
|·||············
|·||·|||·||||···
|·||·|||·||||···
|·||·······||···
|·||·|||||·||···
|····|||||·||···
··||·||||·······
|·||·||||·|||||.
|·||······|HHHHH
|·····|||·|HHHHH
|·|||||||·|HHHHH
|·|||||||·||||||
|····||||·······
|·||······||||··
··||||·||·||||··
|·||||·||·||||··
|·||||·||·||||··
|·||||·||·||||··
|·||||·||·||||··
|·||||·||·||||··
|·||||····||||··
|······||·······
|·|||||||·|||||·
|·|||||||·|||||·
|···············
|||||||·|·||||||
