
|·|||||||||·||||
|···············
··|||·|||·||||··
|·|||·|||·||||··
|·|||·|||·||||··
|·|||·|||·······
|·········|||||·
|·|||||||·|||||·
|·|||||||·|||||·
|·||||····|||||·
|·||||·||·|||||·
|······||·······
|·||·||||·|||||.
|·||·||||·|HHHHH
|····||||·|HHHHH
|·||·||||·|HHHHH
|·||·||||·||||||
|·||·||||·······
|·||·||||·|||||·
|·||·||||·|||||·
|·||·······||||·
|·||·||·||·||···
|·||·||·||·||···
|·||·||·||······
|·||·||·||||·||·
|·······||||·||·
|·|||||·········
|·||||||·||||||·
··||||||·||||||·
|···············
|·|||||||||·||||
