
||||||||||||||||
|···············
|·|||||||·|||||·
|·|||||||·|||||·
|·|||||||·|||···
|·|||||||·|||···
|······||·······
|·||||·||·||||··
|·||||·||·||||··
|·········||||··
|·||||·||·||||··
··||||·||·······
|·||||·||·|||||.
|·||||·||·|HHHHH
|·||||·||·|HHHHH
|·||||·||·|HHHHH
|·········||||||
|·|||||||·······
|·|||||||·||·||·
··|||||···||·||·
|·|||||··||·····
|········||·||··
|·||||||·||·||··
|·||||||·||·|||·
|·||||||·||·|||·
|·||||···||·|||·
|···········|||·
|·|||||||||·|||·
|·|||||||||·|||·
|···············
||||||||||||||||
