
|||||||||||·||||
|···············
|·|||||·||||||··
|·|||||·||||||··
|·|||||·||||||··
|·|||||·········
|·||||||·||||···
|·····||·||||···
|·|||······||···
|·|||·||||·||···
|·|||·||||·||···
|·|||·|||·······
|·····|||·|||||.
|·||·||||·|HHHHH
|·||·||||·|HHHHH
|·||·||||·|HHHHH
|·||·||||·||||||
|·||············
|·||·||||·|||||·
|·||·||||·|||||·
|·||·||||·|||||·
|·········|||||·
|·|||·|||·||····
|·|||·|||····||·
|·|||·····|||||·
|·|||·|||·||||··
|·····|||·||||··
|·|||||||·||||··
|·|||||||·||||··
|···············
|||||||||||·||||
