
||||||||||||||·|
|···············
|·||·|||||·||||·
|·||·|||||·||||·
|····|||||·||···
|·||||·····||···
|·||||·|||······
|······|||·|||··
|·||||·||··|||··
··||||·||·||||··
|·||||·||·||||··
|·||············
|····||||·|||||.
|·|||||||·|HHHHH
|·|||||||·|HHHHH
|·········|HHHHH
|·||||·||·||||||
|·||||·||·······
|·||||·|||||·||·
|·······||||·||·
|·|||||·||||·||·
··|||||·||||·||·
|·|||||·||||·||·
|············||·
|·|||||||||·|||·
|·|||||||||·|||·
|············||·
|·|||||||·||·||·
|·|||||||·||·||·
|···············
||||||||||||||·|
