
||||||||||||||||
|···············
|·|||||·||||·||·
|·|||||·||||·||·
|·|||||·||||····
|·|||||··|||·||·
|········|||·||·
|·|||·||·|||·||·
|·|||·||·····||·
|·|||·||·||||||·
|·|||·||·||||||·
|·|||·||········
|·||······|||||.
|····||||·|HHHHH
··|||||||·|HHHHH
|·|||||||·|HHHHH
··········||||||
|·||||·||·······
|·||||·|||||·||·
|·|||··|||||·||·
|·|||·||||||·||·
|·····||||||·||·
|·|||···········
|·|||·||||||||··
|·|||·||||||||··
|·|||·|||·······
|·|||·····||·||·
|·|||·||||||·||·
|·|||·||||||·||·
|···············
||||||||||||||||
