
|·||||||||||||||
|···············
|·||||||||||||··
|·||||||||||||··
··||||||········
|····|||·||||||·
|·||·|||·||||||·
|·||············
|·||·|||||·||||·
|·||·|||||·||||·
|·||····||·||||·
|·||·||·········
|····||||·|||||.
··|||||||·|HHHHH
|·|||||||·|HHHHH
|·|||||||·|HHHHH
|·|||||||·||||||
················
|·||·||||·|||||·
|·||·||||·|||||·
|·||·||||·|||||·
|·||·||||·|||||·
|·||············
|·||·||||||||···
|····||||||||···
|·||············
··||||||·||||···
|·||||||·||||···
|·||||||·||||···
|···············
|·||||||||||||||
