
||||||||||||||||
|···············
|·||||||||·||||·
|·||||||||·||||·
|············||·
|·||||||·|||·||·
|·||||||·|||·||·
|········|||·||·
|·||||····||·||·
|·||||·||·||·||·
|·||||·||·||·||·
|······||·······
··||||·||·|||||.
|·||||·||·|HHHHH
|·||||·||·|HHHHH
|·||||·||·|HHHHH
|·||||·||·||||||
|·||||·||·······
·······||·|||||·
|·||||····|||||·
|·|||||||·||||··
|····||||·||||··
|·||·||||·||||··
|·||············
|·||·||||·|||···
|·||·||||·|||···
|·||···||·|||···
|·||||·||·|||···
|·||||·||·|||···
|···············
||||||||||||||||
