
||||||||||||||||
|···············
|·|||·||·||||···
|·|||·||·||||···
|·|||·||·||||···
|·|||·||·||||···
|·····||········
|·|||·||·|||·||·
|·|||·||·|||·||·
|·|||·||·|||·||·
|·||······||·||·
|·||·||||·······
|·||·||||·|||||.
|·||·||||·|HHHHH
|·||·||||·|HHHHH
|·||······|HHHHH
|·||·||||·||||||
|····||||·······
|·||·||||·|||||·
|·||·||···|||||·
|·||············
|·||·||||·|||||·
|·||·||||·|||||·
|·||·········||·
|·||·|||·|||·||·
|·||·|||·|||·||·
|·||·|||·|||·||·
|·||·|||·|||·||·
|·||·|||·|||·||·
|···············
||||||||||||||||
