
||||||||||||||||
|···············
|·||·||·|||||||·
|·||·||·|||||||·
|····||·|||||||·
|·|||||·········
··|||||·|||||||·
|····||·|||||||·
|·||·||·||·||···
|·||······|||···
|·||||·||·|||···
|·||||·||·······
|······||·|||||.
|·||||·||·|HHHHH
|·||||·||·|HHHHH
|·||||·||·|HHHHH
|·||||·||·||||||
|·||||·||·······
|·||||·||·|||||·
|·||||·||·|||||·
|·········|||···
|·||·||·|||||···
|·||·||·||······
|·||·||····||||·
··||·||·||·||||·
|·||·||·||·||||·
|·||·||·||······
|·||·||·|||||||·
|·||·||·|||||||·
|···············
||||||||||||||||
