
|·|||||||·||||·|
|···············
|·||·|||||·||||·
|·||·|||||·||||·
|·||·|||||·||||·
|·||·|||||······
|·||·······||||·
|·||·|||||·||||·
|·||·|||||·|||··
|·······||·|||··
|·|||||·||·|||··
|·|||||·········
|·|||·····|||||.
|·|||·|||·|HHHHH
|·|||·|||·|HHHHH
|·|||·|||·|HHHHH
|·|||·|||·||||||
|···············
|·||||·|||||||··
|·||||·|||||||··
|·||||·|||||||··
|·||||·|||||||··
|···············
|·||||·||·|||||·
|·||||·||·|||||·
|·||||·||·||····
|·||||·||····||·
|·||||·||·|||||·
|·||||·||·|||||·
|···············
|·|||||||·||||·|
