
||||||||||·|||||
|···············
|·||||·|||·||||·
|·||||·|||·||||·
|·||||·|||······
|·||||·|||·||···
|·||||·|||·||···
|··········||···
|·|||||·||·||···
|·|||||·||·||···
|·|||||·||·||···
|·|||···········
|·····|||·|||||.
|·||·||||·|HHHHH
|·||·||||·|HHHHH
|·||·||||·|HHHHH
|·||·||||·||||||
|···············
|·||·||·||·||···
|·||·||·||·||···
|·||·||·||·||···
|·||·||····|||··
|·||·||·||·|||··
|·||·||·||·|||··
|·||·||·||······
|·||····||||·||·
|·||·||·||||·||·
|·||·||·||||·||·
|·||·||·||||·||·
|···············
||||||||||·|||||
