
||||||||||||||||
|···············
|·||||·||||||···
|·||||·||||||···
|·||||·····||···
|······|||·||···
|·||·|||||·||···
|·||·|||||·||···
|·||·|||········
|·||·|||·||||||·
|·||·|||·||||||·
|·||············
|······||·|||||.
|·||||·||·|HHHHH
|·||||·||·|HHHHH
|·||||·||·|HHHHH
|·||||·||·||||||
|·||||··········
|·||||·||||||||·
|······||||||||·
|·||||·||||·····
|·||||···||·||··
|····|||····||··
|·||·|||·||||···
|·||·|||·||||||·
|·||·|||·||||||·
|···············
|·||||·||||||···
|·||||·||||||···
|···············
||||||||||||||||
