
||||||||||||||||
|···············
|·||·|||||·||···
|·||·|||||·||···
|·||·|||||·||···
|·||·|||||·||···
|·||····||·||···
|·||·||·||·||···
|·||·||·········
|·||·||···|||||·
··||·||||·|||||·
|·||·||||·······
··||······|||||.
··||·||||·|HHHHH
|····||||·|HHHHH
|·||||····|HHHHH
|·|||||||·||||||
··|||||||·······
··|||||||·||·||·
|·········||·||·
··|||·||·||··||·
|·|||·||·||·|||·
|·|||·······|||·
|·|||·|||||··||·
|·····||||||·||·
|·|||·||··||·||·
|·|||········||·
|·||||·|||||·||·
|·||||·|||||·||·
|···············
||||||||||||||||
