
|||·|||||||||··|
|···············
|·||·||·|||·||··
|·||·||·|||·||··
|·||·||·||··||··
|·||·||·||·|||··
|·||·||····|||··
|·||·|||||·|||··
|·||·|||||·|||··
|·······||·|||··
|·|||||·||·|||··
|·|||||·········
|·|||||||·|||||.
|·|||||||·|HHHHH
|·|||||||·|HHHHH
|·||······|HHHHH
|····||||·||||||
|·||·||||·······
|·||·|||||·||||·
|·||·||·||·||||·
|·||·||····||||·
|·||·||·||·||||·
|·||·||·||······
|·······||||·||·
|·|||·||||||·||·
|·|||·||||···||·
|·|||·||||·||||·
|·|||·||||·||||·
|·|||·||||·||||·
|···············
|||·|||||||||··|
