
||||||||||||||||
················
|·||·||||||·|||·
|·||·||||||·|||·
|·||·||||||·|||·
|·||········|||·
|·||·||||||·|||·
|·||·||||||·|||·
|·||············
|·|||||·||||||··
|·|||||·||||||··
|···············
|·||·||||·|||||.
|·||·||||·|HHHHH
|·||·||||·|HHHHH
|·||·||||·|HHHHH
|·||······||||||
|·||·||||·······
|····||||·|||···
|·||·||||·|||···
|·||·||···|||···
|·······|||||···
|·|||·|||||·····
|·|||·|||||·|||·
|·|||·······|||·
|·|||·|||||··||·
|·····||||||·||·
|·|||·||||||·||·
|·|||·||||||·||·
················
||||||||||||||||
