
|||·||||||·|||||
|···············
|·||·||·||||·||·
··||·||·||||·||·
··||·||······||·
|·||·|||||||·||·
|·||···|||||·||·
|·||||·|||||·||·
|·||||··········
|······||||||||·
|·||||·||||||||·
|·||||··········
|·||||·||·|||||.
|·||||·||·|HHHHH
|·········|HHHHH
|·||·||||·|HHHHH
|·||·||||·||||||
|·||·||||·······
|····||||·||·||·
|·|||||||·||·||·
|·||||····||·||·
|······||·||····
|·|||||||·|||||·
|·||||||··|||||·
|·||||||·|||····
|········|||·||·
··||||||·····||·
··||||||·||||||·
|·||||||·||||||·
|···············
|||·||||||·|||||
