
|·||||||·|||||||
|···············
|·||·||||||||||·
··||·||||||||||·
|·||············
|·||·||·|||||···
|····||·|||||···
|·|||||·|||||···
|·|||||·||·||···
|····||···|||···
|·||·||||·|||···
|·||·||||·······
|·········|||||.
|·|||||||·|HHHHH
|·|||||||·|HHHHH
|·|||||||·|HHHHH
|·····|||·||||||
|·|||···········
|·|||||||·|||···
|·|||||||·|||···
|·········|||···
|·|||||||·|||···
|·|||||||·|||···
|···········||··
|·||||||·||·||··
|·||||||·||·····
|·||||||·|||·||·
··||||||·|||·||·
|·||||||·|||·||·
|···············
|·||||||·|||||||
