
||||||||||||||||
|···············
|·||·|||||·||||·
|·||·|||||·||||·
|····|||||·||||·
|·||············
|·||·||||||||||·
|·||·||||||||||·
|·||·······||···
|·||·|||||·||···
|·||·|||||·||···
|···············
|·|||·|||·|||||.
|·|||·|||·|HHHHH
··|||·|||·|HHHHH
|·|||·|||·|HHHHH
··|||·|||·||||||
|···············
|·|||·||·||||···
|·|||·||·||||···
|·|||·||·||||···
|·|||·||·||||···
|·····||·||||···
|·||||||········
|·||||||·||·|||·
|········||·|||·
|·|||||·||······
|·|||||·||||·||·
|·|||||·||||·||·
|···············
||||||||||||||||
