
|||||||||||·||||
|···············
··|||||·||·||||·
|·|||||·||·||||·
··|||||·||·||||·
···········||||·
|·||||·|||··||··
|·||||·||||·||··
··||||·||||·||··
|·||||···||·||··
|········||·||··
|·||·|||········
|·||·||||·|||||.
|·||···||·|HHHHH
|·||||·||·|HHHHH
|·||||·||·|HHHHH
|·||||·||·||||||
|···············
|·||||||·||||||·
|·||||||·||||||·
|·||||||·····||·
|········|||·||·
··||||||·|||·||·
|·||||||·|||·||·
|···············
··||||····||||··
··||||····||||··
|·||||·|||||||··
··||||·|||||||··
|···············
|||||||||||·||||
