
|·|·||·||·||||||
|···············
|·|||·|||||·|||·
|·|||·|||||·|||·
|······||||·|||·
|·||||······|||·
|·||||·||||·····
|·||||·||||·|||·
|·||||·||||·|||·
··||||·||||·|||·
|·||||·||||·|||·
|···············
|·|||||||·|||||.
|·|||||||·|HHHHH
|·|||||||·|HHHHH
|·········|HHHHH
|·||·||||·||||||
|·||·||||·······
|·||·||||··||||·
|·||·||····||||·
|·||·||·||·||||·
········||·||||·
|·||||||||·||||·
|·||||||||·||||·
|·|||||||·······
|·|||||||·||||··
|·········||||··
|·|||||||·||||··
|·|||||||·||||··
|···············
|·|·||·||·||||||
