
||||||||||||||||
|···············
|·|||·||·|||·||·
|·|||·||·|||·||·
|·|||·||·|||·||·
|·····||·|||·||·
|·|||·||········
|·|||·||·||||···
|·|||·||·||||···
|·|||·||·||||···
|·····||·||||···
|·|||···········
|·|||·|||·|||||.
|·|||·|||·|HHHHH
|·|||·|||·|HHHHH
|·|||·|||·|HHHHH
|······||·||||||
|·||||·||·······
|·||||····|||||·
|·|||||||·|||||·
|·|||||||·||||··
|···············
|·||·||||·||·||·
|·||·||||·||·||·
|·||·||||·||·||·
|·||·||||·||·||·
|·||·||||·||·||·
|·||·||||·||·||·
|·||·||||·||·||·
|···············
||||||||||||||||
