
||||||||||||||||
|···············
|·|||||||·||·||·
|·|||||||·||·||·
|·········||·||·
|·|||||||·||····
|·|||||||·|||···
|·|||||||·|||···
|···············
|·|||||||||||···
|·|||||||||||···
|···············
|·|||·|||·|||||.
|·|||·|||·|HHHHH
|·|||·|||·|HHHHH
|·|||·|||·|HHHHH
|·········||||||
|·|||||||·······
|·|||||||·||·||·
|·····||··||·||·
|·|||·||·|||·||·
|·|||·||·|||·||·
|·|||·||·|||·||·
|·|||········||·
|·|||·||||||·||·
|·|||·||||||·||·
|·||·········||·
|·||·||||||·|||·
|·||·||||||·|||·
|···············
||||||||||||||||
