
|·|||||··|||||||
|···············
|·||||·||·||||··
|·||||·||·||||··
|·||||·||·||||··
|·||||·||·||||··
|·||||·||·······
|·||||·||·|||||·
|·||||····|||||·
|·||||·||·|||||·
|······||·|||||·
|·|||·|||·······
|·|||·|||·|||||.
|·|||·|||·|HHHHH
|·|||·|||·|HHHHH
|·········|HHHHH
|·|||||||·||||||
|·|||||||·······
|·|||||||·||·||·
|·········||·||·
|·|||||||·||·||·
|·|||||||·||·||·
|·|||·····||·||·
|·|||·||||||·||·
|·····||||||····
|·|||········||·
|·|||||·||||·||·
|·|||||·||||·||·
|·|||||·||||·||·
|···············
|·|||||··|||||||
