
||||||||||||||||
|···············
|·||||·||||||···
|·||||·||||||···
|·||||·||||||···
|·||||·||··||···
|··········||···
|·||·||·||·||···
|·||·||·||······
|·||·||····||||·
|·||·||||··||||·
|·||·||||·······
|·········|||||.
|·|||||||·|HHHHH
|·|||||||·|HHHHH
|·|||||||·|HHHHH
|·|||||||·||||||
|·||||··········
|······||·||||··
|·||·||||·||||··
|·||·||||·||||··
|·||·||||·||||··
|·||············
|·||·||···|||||·
|·||·||||·|||||·
|·||··|||·|||||·
|·|||·|||·|||||·
|·|||·|||·|||||·
|·|||·|||·|||||·
|···············
||||||||||||||||
