
||||||||||||||||
|···············
|·||||·|||||·||·
|·||||·|||||·||·
|·||||·|||||·||·
|·||||··········
|······||||||||·
|·||||·||||||||·
|·||||··········
|·||||·|||||||··
|·||||·|||||||··
|···············
|·|||||||·|||||.
|·|||||||·|HHHHH
|·|||||||·|HHHHH
|·|||||||·|HHHHH
|·········||||||
|·|||||||·······
|·|||||||·||||··
|·||||····||||··
|······||·||||··
|·||||·||·||||··
|·||||··········
|······|||||||··
|·||||·|||||||··
|·||||······||··
|·||||·||||·||··
|·||||·||||·||··
|·||||·||||·||··
|···············
||||||||||||||||
