
||||||||||||·||·
|···············
|·||·||||||||||·
|·||·||||||||||·
|·||············
|·||·|||||||·||·
|·||·|||||||·||·
|············||·
|·||·|||||||·||·
··||·|||||||·||·
|·||····||||·||·
··||·||||·······
|·||·||||·|||||.
|·||······|HHHHH
|····||||·|HHHHH
|·||·||||·|HHHHH
|·||·||||·||||||
|·||·||||·······
|·········|||||·
··|||||·|||||||·
|·|||||·||··|||·
··|||||·····|||·
|····||·||··|||·
|·||·||·||······
|·||·||·||·||||·
|·||·······||||·
|·||||·|||···||·
|·||||·|||||·||·
|·||||·|||||·||·
|···············
||||||||||||·||·
