
|||||||||||||·||
|···············
|·||·||||||·|||·
|·||·||||||·|||·
|·||·||||||·····
|·||········|||·
|·||·|||·||·|||·
|·||·|||·||·||··
|····|||····||··
|·||·····||·||··
|·||··|||||·||··
|·||··|||·······
|·||·||||·|||||.
|····||||·|HHHHH
|·||··|||·|HHHHH
|·|||·|||·|HHHHH
|·|||·····||||||
|·|||·|||·······
|·|||·|||·||·||·
|·|||·|||·||·||·
|·····|||·||·||·
|·||······||·||·
|·||·||||·||·||·
|·||·||||·||·||·
|·||·||||·||·||·
|·||······||·||·
|·····|||····||·
|·|||||||·||·||·
|·|||||||·||·||·
|···············
|||||||||||||·||
