
||||||||||··||||
|···············
|·||||||||·||||·
|·||||||||·||||·
|··········||||·
|·||||||||·||||·
|·||||||||·||||·
|···············
|·|||||||·||||··
|·|||||||·||||··
··|||||||·||||··
|·|||||||·······
|·||||····|||||.
|·||||·||·|HHHHH
|·||||·||·|HHHHH
|······||·|HHHHH
|·|||··||·||||||
|·|||···········
|·|||·||||·||||·
|·|||·||||·||||·
······||||·||||·
|·|||·||||·||||·
|·|||······||||·
|·|||·||||·||||·
|·|||·||||······
|······|||·||||·
|·||||·|||·||||·
|·||||·|||·||||·
|·||||·|||·||||·
|···············
||||||||||··||||
