
||||·||||||·||||
················
|·||·|||·|||·||·
|·||·|||·|||·||·
|·||··||·|||·||·
|·||··||·|||·||·
|·||·|||·|||·||·
|·||·||·········
|·······||·||||·
|·||||||||·||||·
|·||||||||·||||·
|·|||||||·······
|·|||||||·|||||.
|·········|HHHHH
|·||·||||·|HHHHH
|·||·||||·|HHHHH
|·||·||||·||||||
|···············
|·||||||·|||·||·
|·||||||·|||·||·
|·········||·||·
|·|||||||·||·||·
|·|||||||·||····
|·|||||||·|||||·
|·|||||||·|||||·
|···············
|·||||||||·||||·
|·||||||||·||||·
|·||||||||·||||·
················
||||·||||||·||||
