
|||||·||||||||||
|···············
|·|||||·||||||··
|·|||||·||||||··
|···············
|·|||||||·|||||·
|·|||||||·|||||·
|·········|||||·
|·||·||||·||||··
|·||·||||·||||··
|·||·||||·||||··
|···············
|·|||·|||·|||||.
|·|||·|||·|HHHHH
|·|||·|||·|HHHHH
|·|||·|||·|HHHHH
|·|||·|||·||||||
|···············
|·||||·||||||···
|·||||·||||||···
|·||············
|·||·||·|||||···
|·||·||·|||||···
|·||·||·|||||···
|·||·||·········
|·||·||·|||||···
|·||·||·|||||···
|·||·||·|||||···
|·||·||·|||||···
|···············
|||||·||||||||||
