
||||||||||||||||
|···············
|·||||||·|||·||·
|·||||||·|||·||·
|········|||·||·
|·|||·||·|||·||·
|·|||·||·|||·||·
|·|||·||·····||·
|·|||·||·|||·||·
|·····||·|||·||·
|·|||·||·|||·||·
|·|||···········
|·|||·|||·|||||.
|·||··|||·|HHHHH
|·||·||||·|HHHHH
|·||·||||·|HHHHH
|·||·||||·||||||
|·||·||·········
|·||·||·||·||···
|·······||·||···
|·|||||·||·||···
|·|||||·||·||···
|·|||||·||·||||·
|·|||||·||·||||·
|·|||||·||·|||··
|···············
|·|||·||||||·||·
|·|||·||||||·||·
|·|||·||||||·||·
|···············
||||||||||||||||
