
|||||||||||||·||
|···············
|·||||·|||·||||·
|·||||·|||·||||·
|·||||·|||·||||·
|·||||··········
|·||||·||||||||·
|······||||||||·
|·||||·····||···
|·||||||||·||···
|·||||||||·||···
|·|||||||·······
|·········|||||.
|·|||||||·|HHHHH
|·|||||||·|HHHHH
|····||||·|HHHHH
|·||·||||·||||||
|·||············
|·||||·||||||···
|·||||·||||||···
|···············
|·||·||||·||·||·
|·||·||||·||·||·
|·||·||||·||····
|·||······||||··
|·||·||||·||||··
|·||·||||·······
|·||·||||·|||||·
|·||·||||·|||||·
|···············
|||||||||||||·||
