
|·||·|||||||||||
|···············
··||||·||||·||··
|·||||·||||·||··
|·||||·||||·||··
··||||······||··
|·||||·||||·||··
|······||||·||··
|·||||·||||·||··
|·||||·||||·||··
|·||||···||·||··
|·||||··········
|······||·|||||.
|·||||·||·|HHHHH
|·||||·||·|HHHHH
|·||||·||·|HHHHH
|·||||·||·||||||
|···············
|·||||·||||·|||·
|·||||·||||·|||·
|·||||··|||·|||·
|·|||||·|||·|||·
|····||·········
|·||······||·||·
|·||||·||·||·||·
··||||·||·||·||·
|·||||·||·||·||·
|·||||·||·||·||·
··||||·||·||·||·
|···············
|·||·|||||||||||
