
||||||||||||||||
|···············
|·||||·|||·||||·
|·||||·|||·||||·
|·||||·|||··|||·
|·||·····||·|||·
··||·|||·||·····
|·||·|||····||··
|····|||·||·||··
|·||||||·|||||··
|·||||····||||··
|·||···||·······
|·||·||||·|||||.
|····||||·|HHHHH
|·||·||||·|HHHHH
|·||·||||·|HHHHH
|·||·||||·||||||
|·||············
|·||·|||||·||||·
|·||·|||||·||||·
|······|||·||||·
|·||||··········
|·||||·||||||···
|·||||·||||||···
··||||·||·······
|·||||·||·|||···
|······||·|||···
|·||||·||·|||···
|·||||·||·|||···
|···············
||||||||||||||||
