
|||||·||||||||||
|···············
|·||||||||·||||·
|·||||||||·||||·
|····|||||······
|·||········||··
|·||||·||||·||··
|·||||·||||·||··
|·||||···||·||··
|·||||||·||·||··
|·····||·||·||··
|·|||···········
|·||||·||·|||||.
|·||||·||·|HHHHH
|·||||····|HHHHH
|·||||·||·|HHHHH
|·|||||||·||||||
|·|||||·········
|·······||||·||·
|·|||||·||||·||·
|·|||||·||||·||·
|·|||||·||||·||·
|···············
|·|||||||·||||··
|·|||||||·||||··
|·||······||||··
|·||·||||·||||··
|·||·||||·||||··
|·||·||||·||||··
|···············
|||||·||||||||||
