
||||||||·|||||||
|···············
|·||||·||||·||··
|·||||·||||·||··
|······||||·||··
|·||||·||||·||··
|·||||······||··
|·||||·|||·||||·
··||||·|||·||||·
|······|||·||||·
|·||||·|||·||||·
|·||||··········
|····||||·|||||.
|·||·||||·|HHHHH
|·||·||||·|HHHHH
|·||···||·|HHHHH
|·||||·||·||||||
|·||||··········
|·||||||·||·|||·
|·||||||·||·|||·
|········||·····
|·||||||·|||·||·
··||||||·|||·||·
|·||··||·|||·||·
|·||··||·|||·||·
|·||·········||·
|·||·||·||||·||·
|·||·||·||||·||·
|·||·||·||||·||·
|···············
||||||||·|||||||
