
|||||||||||||·||
|···············
|·||||||||·|||··
|·||||||||·|||··
······||||·|||··
|·|||··|||·|||··
|·||||·||·······
|·||||····||||··
··||||·||·||||··
|·||||·||·||||··
|·||||·||·||||··
|······||·······
|·|||||||·|||||.
|·|||||||·|HHHHH
|·········|HHHHH
|·|||·|||·|HHHHH
|·|||·|||·||||||
|·|||·||········
|·|||·||·||||||·
|·····||·||||||·
|·|||·||········
|·|||·||·|||·||·
··|||····|||·||·
|·|||·||·|||·||·
|·|||·||·|||·||·
|·|||·||·|||·||·
······||·····||·
|·|||·||||||·||·
|·|||·||||||·||·
|···············
|||||||||||||·||
