
||||||||||||||||
|···············
|·|||||||·||·||·
|·|||||||·||·||·
|············||·
··|||·||||||·||·
|·|||·||||||·||·
|·||·········||·
|·||·||||·||·||·
|·||·||||·||·||·
|·||·||||·||·||·
|·||·||||·······
|·||·||||·|||||.
|·||······|HHHHH
|·||·||||·|HHHHH
|·||·||||·|HHHHH
|·········||||||
|·|||||||·······
|·|||||||·|||||·
|·|||||||·|||||·
|·|||||||·|||||·
|··········||||·
|·|||·||||·||||·
|·|||·||||······
|·|||·||||·||||·
··|||·||||·||||·
|··········||···
|·||||||||·||···
|·||||||||·||···
|···············
||||||||||||||||
