
|·|||||||·||||||
|···············
|·|||||·||||·||·
|·|||||·||||·||·
|·|||||·||||·||·
|·|||||·||||·||·
|·|||||·||||·||·
|·|||||·||||·||·
|········|||····
|·|||·||··||·||·
|·|||·|||·||·||·
|·|||·|||·······
··|||·|||·|||||.
··········|HHHHH
|·|||·|||·|HHHHH
|·|||·|||·|HHHHH
|·····|||·||||||
··|||·|||·······
··|||·||||·||||·
|·|||·||||·||||·
|·|||·||||·||||·
|·|||·||||······
|·|||······||||·
|·····||·||||||·
|·||||||·||·····
|·||||||·||·||··
|···········||··
|·||||||·|||||··
|·||||||·|||||··
|···············
|·|||||||·||||||
