
||||·|||||||·|||
|···············
|·||||·||||||||·
|·||||·||||||||·
|·||||·||·······
|·||||·||·||·||·
|·········||·||·
|·|||||||·||·||·
|·|||||||·||·||·
|·|||||···||·||·
|·|||||···||·||·
|···············
|·|||·|||·|||||.
|·|||·|||·|HHHHH
|·|||·|||·|HHHHH
|·|||·|||·|HHHHH
|·········||||||
|·||·||||·······
|·||·|||||·||···
|·||·||·||·||···
|·||·||····||···
|·||····||·||||·
|·||·|||||·||||·
|·||·|||||······
|·||·|||||·||||·
|······|||·||||·
|·||||·····||···
|·||||·|||·||···
|·||||·|||·||···
|···············
||||·|||||||·|||
