
|||||||||||·|||·
|···············
|·||||||||·||||·
|·||||||||·||||·
|·||············
|·||·||·||||||··
|·||·||·||||||··
|···············
|·|||·||||||||··
|·|||·||||||||··
|·|||·||||||||··
|·|||·|||·······
|·········|||||.
|·|||||||·|HHHHH
|·|||||||·|HHHHH
|·|||||||·|HHHHH
|·|||||||·||||||
|···············
|·||·||||||||||·
|·||·||||||||||·
|···············
|·|||||||·|||||·
|·|||||||·|||||·
|·|||||||·|||||·
|·····|||·|||||·
|·|||·|||·|||||·
|·|||···········
|·|||||·||||||··
|·|||||·||||||··
|···············
|||||||||||·|||·
