
||||||||||||||||
|···············
|·||·||||·||||··
|·||·||||·||||··
|·||·||||·||||··
|······||·||||··
··||||·||·||||··
|·||||··········
|·|||||·||||·||·
|·|||||·||||·||·
|·······||||·||·
|·|||||·········
|·|||||||·|||||.
|·|||||||·|HHHHH
|·|||||||·|HHHHH
|······||·|HHHHH
|·|||·|||·||||||
|·|||·||········
|········||||···
|·||||||·||||···
|·||||||·||||···
|·||||||·||||···
|·|||||·········
|·······|||·|||·
··|||||·|||·|||·
|·|||||··||·||··
|·|||····||·||··
|·|||·||·||·||··
|·|||·||·||·||··
|···············
||||||||||||||||
