
|||||||||||·||||
|···············
|·||||·||||||···
|·||||·||||||···
|······||||||···
|·|||····||||···
|·|||·||········
|·|||·||·||||||·
|·|||·||·||||||·
|·····||··|||||·
|·|||||||·|||||·
|·|||||||·······
|·········|||||.
|·|||||||·|HHHHH
|·|||||||·|HHHHH
|·|||||||·|HHHHH
|·|||||||·||||||
|·|||···········
|·····|||||||···
|·|||·|||||||···
|·|||·|||||||···
|·|||·|||||||···
|···············
|·||||·|||||·||·
|·||||·|||||·||·
|·||||·|||···||·
|·||||·····||||·
|·||||·|||·||||·
|·||||·|||·||||·
|···············
|||||||||||·||||
