
||||||||||||||||
|···············
|·||||·|||·||···
|·||||·|||·||···
|·||||·|||·||···
|······|||·||···
|·||||·|||·|||··
|·||||·····|||··
|·||||·||·······
|·||||·||·|||||·
|·········|||||·
|·|||||||·······
|·|||||||·|||||.
|·|||||||·|HHHHH
|·········|HHHHH
|·||||·||·|HHHHH
|·||||·||·||||||
|·||||·||·······
|·||||·||·||||··
|······||·||||··
|·||||·||·||||··
|·||||·||·||||··
|·········||||··
|·||||||········
|·||||||·||||||·
|·|||····||||||·
|·|||·||·|||····
|·|||·||·|||·||·
|·|||·||·|||·||·
|···············
||||||||||||||||
