
||||||||||||||||
|···············
|·||||||·||||···
|·||||||·||||···
|·|||····||||···
|·····||·||||···
|·||||||·||·····
|·||||||·||··||·
|·||||||·||··||·
|·········||·||·
|·|||||||·||·||·
|·|||||||·······
|·········|||||.
|·|||||||·|HHHHH
|·|||||||·|HHHHH
|·|||||||·|HHHHH
|·|||||||·||||||
|····||·········
|·||·||·|||·|||·
|·||·||·|||·|||·
|·||·||·|||·|||·
|·||·||·|||·|||·
|·||············
|·||·||||||·|||·
|·||·||||||·|||·
|···············
|·|||||||·||||··
|·|||||||·||||··
|·|||||||·||||··
|···············
||||||||||||||||
