
||||||||||||·|||
|···············
|·||·||·|||||||·
|·||·||·|||||||·
|·||·||···|||||·
|····||||·|||||·
|·||·||||·||||··
|·||············
|·||·|||||·||||·
|·||·|||||·||||·
|·||·|||||·||||·
|·||············
|·||·||||·|||||.
|·||·||||·|HHHHH
|·||·||||·|HHHHH
|·||·||||·|HHHHH
|·········||||||
|·||||·||·······
|·||||·|||·||||·
|·||||·|||·||||·
|······|||·||||·
|·|||··|||·||||·
|·|||···········
|·||||||||·|||··
|·||||||||·|||··
|···········||··
|·||||||·||·||··
|·||||||·||·||··
|·||||||·||·||··
|···············
||||||||||||·|||
