
||||·||||||·||||
|···············
··||||||·|||·||·
|·||||||·|||·||·
|·||||||·|||·||·
|·||||||·|||·||·
|············||·
|·||||·|||·||||·
|·||||·|||·||||·
··||||·|||·||||·
|·||||·|||·||||·
|···············
|·|||·|||·|||||.
|·|||·|||·|HHHHH
|·····|||·|HHHHH
|·|||||||·|HHHHH
|·|||||||·||||||
|···············
|·|||·|||||||||·
|·|||·|||||||||·
|·|||········||·
··|||·||||||····
|·|||·||||||·||·
|·|||·||·····||·
|·····||·|||·||·
|·|||·||·|||·||·
|·|||·||·····||·
|·|||·||·||||||·
··|||·||·||||||·
|···············
||||·||||||·||||
