
||||||·|||||||||
|···············
|·||||||·||||||·
··||||||·||||||·
|·||||||········
|·||||||·|||||··
|········|||||··
|·||||||····||··
|·||||||·||·||··
|········||·||··
|·||||·||||·||··
|·||||·||·······
··||||·||·|||||.
|······||·|HHHHH
|·||||····|HHHHH
|·||||·||·|HHHHH
|·||||·||·||||||
|·||||··········
··||||·|||·||||·
|······|||·||||·
|·|||··|||·|||··
|·|||···||······
|·|||||·||·||||·
|·|||||·||·||||·
|····||·||·||||·
|·||········|||·
|·||||·||||·····
··||||·||||·|||·
|·||||·||||·|||·
|···············
||||||·|||||||||
