
||||||||||··||||
················
|·|||·|||·||||··
|·|||·|||·||||··
··|||·|||·||||··
|·|||·|||·||||··
|···············
|·|||||||·|||||·
|·|||||||·|||||·
··||||····|||||·
|·||||·||·|||||·
|·||||·||·······
|·········|||||.
|·||·||||·|HHHHH
|·||·||||·|HHHHH
|·||·||||·|HHHHH
|·||·||||·||||||
|·||·||||·······
|·||·||||·|||||·
|·········|||||·
|·|||||||·|||||·
··|||||||·······
|·|||||||·||||··
|·········|||||·
|·|||||||·|||||·
|·|||||||·|||||·
················
|·||||||·||||||·
|·||||||·||||||·
················
||||||||||··||||
