
||||||··|··|||||
|···············
|·||||||·||·|||·
|·||||||·||·|||·
|············||·
|·||||||·|||·||·
|·||||||·|||·||·
|·||||||·|||·||·
················
|·||·||||||||···
|·||·||||||||···
|·||·||||·······
|·||······|||||.
|·||·||||·|HHHHH
|·||·||||·|HHHHH
|·||·||||·|HHHHH
|····||||·||||||
|·||·||||·······
|·||·||||·|||||·
|·||······|||||·
|·||·||||·|||||·
|·||·||||·······
··||·||||·|||···
|·········|||···
|·|||||||·|||···
|·|||||||·|||···
|···············
|·||||||·||||||·
|·||||||·||||||·
|···············
||||||··|··|||||
