
|||||||||||·|·||
|···············
|·||||·|||·||||·
|·||||·|||·||||·
|·||||·|||···||·
|·||||··||||·||·
··|||||·||||·||·
··|||||·||||·||·
|············||·
|·|||·||||||·||·
|·|||·||||||·||·
··|||···········
|·|||·|||·|||||.
|·····|||·|HHHHH
|·|||||||·|HHHHH
|·|||||||·|HHHHH
|·|||||||·||||||
|·|||||||·······
|·····|||·|||||·
··|||·|||·|||||·
|·|||···········
|·|||·||||||·||·
|·|||·||||||·||·
················
··||||·||||·||··
|·||||·||||·||··
|·||||·|||··||··
|·||||·|||·||||·
|·||||·|||·||||·
|···············
|||||||||||·|·||
