
|||||||·||||||||
|···············
|·|||||||·|||||·
|·|||||||·|||||·
|·········|||···
|·|||||||·|||···
|·|||||||··||···
················
|·|||·||··|||||·
|·|||·||··|||||·
|·····|||·|||||·
|·|||||||·······
|·|||||||·|||||.
|·········|HHHHH
|·|||||||·|HHHHH
|·|||||||·|HHHHH
|·····|||·||||||
|·|||···········
|·|||·||||||·||·
|·|||·||||||·||·
|·|||········||·
|·····||·||·|||·
|·|||·||·||·|||·
··|||·||·||·|||·
|·|||·||·||·····
|·|||·||·||·|||·
|·|||·||·||·|||·
|·|||·||·||·|||·
|·|||·||·||·|||·
|···············
|||||||·||||||||
