
|||·||||·|||||||
|···············
|·|||||||||·|||·
|·|||||||||·|||·
|·|||||||||·····
|···········||··
|·|||·|||||·||··
|·|||·|||||·||··
|·|||·|||||·||··
|·|||·|||||·||··
|·|||·|||||·||··
|·|||···········
|·····|||·|||||.
|·||·||||·|HHHHH
|·||·||||·|HHHHH
|·||·||||·|HHHHH
|·||·||||·||||||
|·||·||||·······
|·||·||||·||·||·
|·||·||||·||·||·
|·||·||||·||·||·
|·||·········||·
|·||·||·||||·||·
|····||·||||·||·
|·|||||·||||·||·
|·|||||·||||·||·
|·|||||·········
|·||||||·||||||·
|·||||||·||||||·
|···············
|||·||||·|||||||
