
||||||||||||||||
|···············
|·||·|||||·||||·
|·||·|||||·||||·
|·||·······||···
|·||||·|||·||···
|·||||·|||······
|······|||·||||·
|·||||·|||·||||·
|·||||·|||·||||·
|·||||·····||||·
|·||···||·······
|·||·||||·|||||.
|····||||·|HHHHH
|·||·||||·|HHHHH
|·||·||||·|HHHHH
|·||···||·||||||
|·||||··········
|·||||·|||||||··
|·||||·|||||||··
|········|||||··
|·||||||·|||||··
|·||||||········
|·····||·||||···
|·|||·||·||||···
|·|||·||·||||···
|·|||·||·||||···
|·|||·||·||||···
|·|||·||·||||···
|···············
||||||||||||||||
