
||||||||||·||··|
|···············
··||||||·||·||··
|·||||||·||·||··
|···········||··
|·||·||||||·|||·
|·||·||||||·|||·
|·||············
|·||·||||·|||···
|·||·||||·||||··
|····||||·||||··
|·||·||||·······
|·||······|||||.
··||·||||·|HHHHH
|·||·||||·|HHHHH
|·||·||||·|HHHHH
|·||·||||·||||||
·····||||·······
|·||·||||·|||||·
|·||···||·|||||·
|·||||·||·||····
|·||||·||·||·||·
|·||||·||·||·||·
|·||||·||·||·||·
|·········||·||·
|·|||||||····||·
|·|||||||·||·||·
|·|||||||·||·||·
··|||||||·||·||·
|···············
||||||||||·||··|
