
|||·||||||||||·|
|···············
|·||·|||·||·||··
|·||·|||·||·||··
|·||·|||·||·||··
|·||·|||·||·||··
|·||·|||·||·||··
|·||·|||····||··
|······||·······
··||||·||·|||||·
|·||||····|||||·
|·|||||||·······
|·|||||||·|||||.
|·········|HHHHH
|·|||||||·|HHHHH
|·|||||||·|HHHHH
|·|||||||·||||||
|·|||||·········
|·······||||||··
|·|||||·||||||··
|·|||||·········
··|||||·|||·||··
|·······|||·||··
|·|||||·|||·||··
|·|||||·|||·||··
|·|||||·|||·||··
|···········||··
|·||·||||||·|||·
|·||·||||||·|||·
|···············
|||·||||||||||·|
