
||||||||·||||||·
|···············
|·|||·||||·||||·
|·|||·||||·||||·
|·|||·||||·||||·
|·|||······||||·
|·|||·||||······
|·····||||·||||·
··|||···||·||||·
|·|||||·||·||||·
|·|||||·||·||||·
|···············
|·||||·||·|||||.
|·||||·||·|HHHHH
|·||||·||·|HHHHH
|·||···||·|HHHHH
|·||·||||·||||||
|····||||·······
|·||·······||||·
|·||·|||||·||||·
|·||·|||||·||||·
|·||·|||||·||||·
··||·|||········
|·||·····||·|||·
|····||||||·|||·
|·||·||||||·|||·
|·||············
|·||||||·||||||·
|·||||||·||||||·
|···············
||||||||·||||||·
