
|·|·|||·||||||·|
|···············
|·||·||||·|||||·
|·||·||||·|||||·
|·||·||||·|||||·
|···············
|·||||||·||||···
|·||||||·||||···
|·||·····||||···
|·||·|||·||||···
|·||·|||·||||···
|·||············
|····||||·|||||.
··|||||||·|HHHHH
|·|||||||·|HHHHH
|·||···||·|HHHHH
|······||·||||||
··||············
|·||····||·||···
|·||·|||||·||···
|·||·|||||·||···
|·||·······||||·
|·|||·||||·||||·
|·|||·||||·||||·
|·····||||······
|·|||·||||·||||·
|·|||·||||·||||·
|·|||·||||·||||·
|·|||·||||·||||·
|···············
|·|·|||·||||||·|
