
|||||||||||||||·
|···············
|·|||·||·|||·||·
|·|||·||·|||·||·
|·|||·||·|||·||·
|·|||·||·|||·||·
|·|||·||·····||·
|·|||·||·|||·||·
|·····||·|||·||·
|·|||····|||·||·
··|||·||·|||·||·
|·|||·||········
|·|||·|||·|||||.
|·····|||·|HHHHH
··|||||||·|HHHHH
|·|||||||·|HHHHH
·····||||·||||||
|·||·|||········
|·||·|||·||||···
|·||··||·||||···
··|||·||·||||···
|·|||···········
|·|||·||||||·||·
|·|||·||||||·||·
|···············
|·||||||·||||···
|·||||||·||||···
|·||||||·||||···
|·||||||·||||···
|···············
|||||||||||||||·
