
||||||||·|||··|·
|···············
|·||||·||·|||||·
|·||||·||·|||||·
|·||||·||·|||||·
|······||·|||||·
|·||·||||·······
|·||·||||·||||··
|·||·||||·||||··
|·||·||||·||||··
··||·||||·||||··
|·||············
|·||·||||·|||||.
|·||·||||·|HHHHH
|····||||·|HHHHH
|·||·||||·|HHHHH
|·||······||||||
|·|||·||········
|·|||·||·||·|||·
|·|||····||·|||·
······||·||·····
|·||||||·||·|||·
|·||||||····|||·
|········||·||··
|·||||||·||·||··
|·||||||·||·||··
|·····||·||·····
|·|||·||·||·|||·
|·|||·||·||·|||·
|···············
||||||||·|||··|·
