
||||||||||||||||
|···············
|·||||||·||||||·
|·||||||·||||||·
|·|||||·········
|·|||||·|||||||·
|·|||||·|||||||·
|············||·
··||||·||·||·||·
··||||·||·||·||·
|·||||·||·||·||·
|·||||·||·······
|······||·|||||.
|·||||·||·|HHHHH
|·||||·||·|HHHHH
|······||·|HHHHH
|·||||·||·||||||
|·||||·||·······
|·||||·||·|||||·
|·||||····|||||·
|······||·······
··||·||||·|||||·
··||·||||·|||||·
|·||··||··||····
|·|||·||·|||·||·
|·|||····|||·||·
|·····||········
|·||||||·||||||·
|·||||||·||||||·
|···············
||||||||||||||||
