
||||||||||||||||
················
|·||·|||||·||||·
|·||·|||||·||||·
|····|||||·||||·
··||············
|·||·|||||||||··
|·||·|||||||||··
|·||········||··
|·||||||·||·||··
··||||||·||·||··
|···············
|·|||·|||·|||||.
··|||·|||·|HHHHH
|·|||·····|HHHHH
|·|||·|||·|HHHHH
|·|||·|||·||||||
·······||·······
|·||||·|||||·||·
|·||||·|||||·||·
··||||·······||·
|·||||·|||||·||·
|·||||·|||||·||·
|·||||·||·······
|·||······|||···
··||·||·|||||···
|····||·||·||···
|·|||||·||·||···
|·|||||·||·||···
················
||||||||||||||||
