
|||·||||||||·|·|
|···············
|·|||·||||·|||··
|·|||·||||·|||··
|·|||·||||·|||··
|·|||·||||·|||··
|·|||·||||······
|·|||·||||·||||·
|··········||||·
|·||·|||||·||||·
|·||·|||||·||||·
|·||·||||·······
|·||·||||·|||||.
|·||······|HHHHH
|·||·||||·|HHHHH
|·||·||||·|HHHHH
|····||||·||||||
|·|||||||·······
|·|||||||·||·||·
|·········||·||·
|·||||·||·||·||·
|·||||·||·||·||·
|·||||·||·||·||·
|·········||·||·
|·|||||||·······
|·|||||||·||||··
|·||||····|||||·
|·||||·||·|||||·
|·||||·||·|||||·
|···············
|||·||||||||·|·|
